abandon	拋棄
abandoned	被拋棄的
absolute	全然的
absolutely	當然
absorb	吸收
abstract	抽象
academic	學術的
academy	學院
accent	重音；在...標上重音
acceptance	接受
access	讀取資料；通道；入口
accessible	易接近的
accidental	意外的
accidentally	意外地
accompany	陪同
accomplish	完成
accomplishment	成果
accountant	會計師
accuracy	精確
accuse	控告；譴責
accusation	控訴
acid	酸
acquaint	使熟悉
acquaintance	相識的人
acquire	獲得；學會
acquisition	獲得物；新手
acre	英畝
adapt	使適應；改編
adequate	足夠的
adequately	足夠地
adequacy	足夠；適當
adjective	形容詞
adjust	調整
adjustment	調整
admirable	值得讚賞的；極佳的
admiration	讚賞；欽佩
admission	承認；入場許可
adverb	副詞
advertisement	廣告
advertising	廣告業
agency	代理業；局
agent	經紀人
aggressive	積極的；攻擊性的
agreeable	愉快的；和藹可親的
AIDS/acquired immune deficiency syndrome	愛滋病
alcohol	酒精；酒
alcoholic	酒精的；酗酒者
alert	警覺的；機靈的；提醒
allowance	零用錢
aluminum	鋁；鋁製的
amateur	業餘愛好者；業餘的
ambitious	野心勃勃的
amid/amidst	在...之間
amuse	逗人笑
amused	覺得有趣的
amusing	引人發笑的
amusement	樂趣
analysis	分析
analyze	分析
ancestor	祖先
anniversary	週年紀念
annoy	使煩惱；困擾
annoying	煩人的
annual	每年一次的；一年的
anxiety	焦慮
anxious	擔心的；急切的
apologize	道歉
apology	道歉
appliance	器具
applicant	申請者
application	應用；申請書
appoint	指定；任命
appointment	任命；官職
appreciation	感謝；鑑賞力
appropriate	適合的
approval	同意
arch	拱門
arise	出現；上升
arms	武器
arouse	喚醒；引起
article	物品；報導；冠詞
artificial	人工的；不自然的
artistic	藝術的；懂藝術的
ashamed	慚愧的
aspect	觀點；角度
aspirin	阿斯匹靈
assemble	集合；裝配
assembly	集會；集合
assign	分配；指定；任命
assignment	工作；指定作業
assistance	幫助
associate	聯想；同事
association	協會；聯合
assume	假定
assurance	保證；自信
assure	保證
athletic	運動的；強壯的
ATM/automatic teller machine	自動提款機
atmosphere	大氣；氣氛
atom	原子；微粒；一點(也沒有)
atomic	原子的
attach	使固定；貼上
attachment	附屬物；附屬
attraction	吸引力；有魅力之處
audio	聲音的；播音的；收音的
audiovisual	視聽的
authority	權威
autobiography	自傳
await	等候
awkward	笨拙的
awkwardly	笨拙地
backpack	背包
bald	禿頭的；不長草的
ballet	芭蕾舞
bankrupt	破產的；使破產
bankruptcy	破產
bargain	殺價；交易；買賣契約
barrier	障礙
basin	水盆；一盆的量
battery	電池
beak	鳥喙
beam	光線
behavior	行為
biography	傳記
biology	生物學
blend	使混合；調和
blessing	天賜的恩惠；同意
blink	眨眼；閃爍
bloom	花；開花；花開
blossom	花；開花；繁榮
blush	臉紅；羞愧
boast	自誇
bond	羈絆，束縛
bounce	彈起；彈力
bracelet	手鐲
brassiere/bra	胸罩
breed	產子；養育；品種
bridegroom/groom	新郎
broke	破產的，身無分文的
brutal	殘忍的；嚴酷的
bulletin	公告
bureau	局
cabinet	櫥櫃
calculate	計算；估計
calculation	計算
calculator	計算機
calorie	卡路里
campaign	活動；參加活動
candidate	候選人
capacity	容量
cape	岬角
capital	首都；資本
capitalism	資本主義
capitalist	資本家
career	(作為一生的)職業
cargo	貨物
carrier	運輸車；搬運人；帶原者
carve	切開；雕割
catalogue/catalog	目錄
CD/compact disk	光碟
cease	停止
celebration	慶祝
cement	水泥
ceremony	儀式
chamber	房間
championship	冠軍資格
characteristic	特徵
charity	慈善事業；慈悲
chemistry	化學
cherish	珍愛
chore	雜務
chorus	合唱團；合唱曲
circular	圓形的；巡迴的
circulate	循環；流傳
circulation	循環；流傳；發行量
circumstance	狀況；情勢
civilization	文明
clarify	澄清
clash	衝突；撞擊聲
classification	分類
classify	把...分類
cliff	峭壁
climax	高潮
clinic	診所
clone	複製品
clumsy	笨拙的
coarse	粗糙的
code	密碼
collapse	倒塌；崩潰
combination	結合
comedy	喜劇；喜劇因素
comic	喜劇的
comic(s)	漫畫
commander	指揮官
comment	評論；發表意見
commerce	商業；貿易
commit	犯(罪、錯)
communication	溝通；通訊系統
community	社區
companion	同伴
competition	競賽
competitive	競爭激烈的；競爭心強的
competitor	競賽者
complicate	使複雜
complicated	複雜的
compose	構成；作曲
composer	作曲家
composition	創作；作文；構成
compute	計算
concentrate	專心於
concentration	專心
concept	概念
concerning	關於...
concrete	具體的；混凝土
conductor	嚮導；指揮；車掌
conference	會議
confess	承認
confession	坦白
confine	限制
confront	面臨
confrontation	對質；衝突
confusion	困惑
congratulate	恭喜
congress	美國國會；會議
conjunction	連接詞；結合
conquer	克服；征服
conscience	良心
consequence	結果
consequent	因...而起的
consequently	因此
conservative	保守的
consist	由...組成；存在於...
consistent	一致的
consonant	子音
constitute	構成
constitution	構成；憲法
construct	建築；構思
construction	建造；建築物
constructive	建設性的
consult	請教；參閱；商議
consultant	顧問
consume	耗光；消費
consumer	消費者
container	容器
content	對...滿足
content(ment)	內容
contest	比賽
context	上下文；周圍狀況
continental	大陸的
continual	連續的；多次發生的
continuous	無間斷的
contrary	相反
contrast	對比；對照
contribute	貢獻；捐
contribution	貢獻；捐贈物
convenience	方便；便利的東西
convention	代表大會
conventional	慣例的；老套的
converse	交談
convey	傳達；運送
convince	使信服
convinced	確信的
convincing	令人信服的
cooperate	合作；協力
cooperation	合作；協力
cooperative	合作的
cope	應付；處理
copper	銅；銅的
cord	繩；電線；肌腱
cork	軟木塞
correspond	與...一致；通信
correspondence	相對應；通信
correspondent	相應的；通訊員
costume	(特定場合、職業的)服裝
cottage	村舍；小別墅
council	會議
counter	櫃檯；計算機
courageous	勇敢的
courteous	禮貌的
courtesy	謙恭有禮
crack	裂縫；破解
craft	技巧；手工業；船；飛機
cram	填鴨式的學習；塞進
creation	創造
creativity	創造力
cripple	殘障者；使殘障
critic	評論家
critical	批評的
criticism	批評；挑剔
criticize	批評
crush	壓碎；擁擠；塞進
cube	方塊；三次方
cucumber	黃瓜
cue	提示
cultivate	耕種；栽培，培養
cunning	狡猾的
curiosity	好奇心
curl	使捲曲；捲髮
curse	詛咒
curve	彎曲；曲線
cushion	墊子；靠墊
damn	詛咒；貶低
damp	潮濕的
deadline	最後期限
declare	宣布；聲明
declaration	宣布；申報
decoration	裝飾；裝潢
decrease	減少
deed	行為
defeat	失敗；擊敗
defend	防禦；辯護
defense	防禦
defensible	能防禦的
defensive	防禦性的
definite	明確的
definitely	清楚地；正式
delicate	細緻的；脆弱的
delicately	優美地；微妙地
delicacy	纖弱；微妙；佳餚
delight	高興；使高興
delightful	令人愉快的
demand	要求
demanding	要求嚴格的；辛苦的
demonstrate	示範；證明；示威
demonstration	示範；示威活動
dense	密集的
depart	出發；離開
departure	出發；離開
dependable	可信賴的
dependent	依賴的
dependence	依賴；信賴
depress	使沮喪
depressed	沮喪的
depressing	令人沮喪的
depression	沮喪；不景氣
deserve	值得；應得
desperate	不顧一切的；嚴重的
desperately	豁出去地；非常地
despair	絕望
desperation	拼命；孤注一擲
despite	儘管；不顧
destruction	破壞
destructive	破壞性的
detective	偵探；探員
determination	決心
device	裝置
devise	設計出；想出
devote	奉獻；致力於
devoted	摯愛的；埋首於...的
devotion	奉獻；摯愛
differ	相異
digest	消化；摘要；文摘
digestion	消化力
digital	數字的；數位的
dignity	莊嚴；尊嚴
diligence	勤勉
diploma	畢業證書
diplomat	外交官
disadvantage	不利的情況
disaster	災禍
disastrous	不幸的
discipline	訓練；教養；紀律；學科
disco	迪斯可舞廳
disconnect	斷絕...關係；切斷...電源
disconnected	斷絕的；切斷的
discourage	使沮喪；勸阻
discouraged	感覺沮喪的
discouraging	令人沮喪的
discouragement	沮喪；氣餒
disguise	假扮；喬裝
disgust	噁心；厭惡
disgusting	令人作嘔的
disgusted	嫌惡的
dismiss	解散；解雇
dismissal	解散；解雇
disorder	雜亂
disorderly	雜亂的
dispute	爭論
distinct	不同的；明顯的
distinction	區別；差異；卓越
distinguish	區別
distinguished	傑出的；著名的
distribute	分送；分布
distribution	分配物
district	地區
disturb	打擾
disturbance	混亂；不安
divine	神的；神聖的
divorce	離婚
dominant	支配的；優勢的
dominate	支配，左右；俯視
dormitory/dorm	宿舍
download	下載
doze	打盹
draft	打草稿
dread	害怕
dreadful	不安的；很差的
drift	漂流；趨勢
drill	鑽孔；練習
durable	耐用的；持久的
duration	持續期間
DVD/digital video disk	數位影音光碟
dye	染色；染料
dynamic	有活力的
dynasty	王朝
earnest	認真
earphone	耳機
economic	經濟的
economical	節約的
economics	經濟學
economist	經濟學家
economy	經濟
efficiency	效率
elastic	有彈力的
electrician	電工
electronics	電子學
elegant	高雅的
elegance	高雅
elementary	基礎的
eliminate	消除
elimination	消除
elsewhere	別處
e-mail/email	電子郵件
embarrass	使尷尬
embarrassed	不好意思的
embarrassing	令人不好意思的
embarrassment	尷尬
embassy	大使館
emerge	出現
emotional	情緒化的
emphasis	強調
empire	帝國
enclose	圍繞；隨信裝入
encounter	遇見；遭遇
endanger	危害
endure	忍受
enduring	持久的
enforce	實行；強迫
enforcement	執行；強迫
engineering	工程學
enlarge	放大
enlargement	放大之物
enormous	巨大的
entertain	娛樂；款待
entertainment	娛樂
enthusiasm	熱忱
enthusiastic	熱心的
envious	嫉妒的
equality	同等
equip	裝上裝備
equipment	設備；必要的知識
era	年代；紀元
errand	差事
escalator	手扶梯
essay	論文
essential	必需品
establish	建立；證實
establishment	建立
estimate	估計；估價
evaluate	評估；評價
evaluation	評價；鑑定
eve	前夕
eventual	最後的
eventually	最後，結果
evidence	證據
evident	明白的；明顯的
evidently	明白地；明顯地
exaggerate	誇張
exaggeration	誇張
examinee	應試者
exception	例外；除外
exhaust	耗盡；排氣
exhausted	精疲力盡的
exhaustion	枯竭
exhibit	展示；展示品
expand	擴大；膨脹
expansion	擴大
experimental	實驗的
explanation	說明
explore	探險；探究
exploration	探險；探究
explosion	爆炸；情緒爆發
explosive	炸藥
expose	使暴露
exposure	暴露；接觸
extend	擴大；延長；表示(邀請，感謝)
extension	延長；分機
extensive	廣大的；大量的
extent	程度；廣大的地區
extraordinary	不平凡的
facial	臉部的
facility	容易；能力；設備
faithful	忠貞的
fame	名譽；使聞名
fantastic	極好的
fantasy	空想
farewell	再見；告辭
fatal	致命的；左右命運的
favorable	贊成的；合適的；偏私的
feast	設宴招待；節日；祭日
ferry	渡船
fertile	肥沃的
fertilize	使肥沃；使受精
fertilizer	肥料
fetch	(去)拿來
fiction	小說；虛構的故事
fictitious	非真實的；假的
fierce	兇猛的；激烈的
fiercely	兇猛地；非常地
finance	財務；財源
financial	財務的；金融的
financially	財政上
firecracker	爆竹
flatter	奉承；諂媚
flattery	阿諛；奉承
flee	逃逸；消逝
flexible	可變通的；有彈性的
flexibility	柔軟度
fluent	流利的；雄辯的
fluently	流利地；流暢地
fluency	流利；流暢
flunk	考試不及格
flush	突然臉紅
foam	起泡沫
forbid	禁止
forbidden	被禁止的
forecast	預報
formation	形成；隊伍
formula	公式；配方
fort	要塞；城堡
fortunate	好運的
fortunately	幸運地
foundation	地基；基礎
founder	創始人
fragrance	芳香；香水
fragrant	芳香的
frame	框住；架構
framework	框架；骨骼；組織
frame-up	誣陷；誣賴
freeway	高速公路
frequency	頻率
freshman	大一新生
frost	用霜蓋上；凍壞(死)
frown	皺眉
frustration	挫折
fuel	補充燃料；激起
fulfill	履行
fulfillment	實現；成就感
functional	機能上的；官能上的；實用的
fundamental	基礎的；主要的
funeral	葬禮
furious	狂怒的；猛烈的
furnish	供給；配備家具
furnishings	家具
furthermore	而且；此外
gallery	畫廊；走廊
gangster	幫派成員；歹徒
gaze	凝視
gear	使驅動；裝上齒輪
gene	基因
genetic	基因的；遺傳學上的
genetics	遺傳學
generation	世代；產生
generosity	慷慨；寬大
genius	天才；才智
genuine	真正的；真誠的
genuinely	真正地；真誠地
germ	微生物；細菌；胚
gifted	有天賦的
gigantic	巨大的
giggle	咯咯地笑
ginger	薑
glide	滑動；滑行
glimpse	瞥見
globe	球體；地球；世界
glorious	光榮的；壯麗的
goods	商品
grace	使...增光彩
graceful	優雅的
gracious	親切的
graduation	畢業(典禮)
grammar	文法
grammatical	文法上的
grapefruit	葡萄柚
grateful	感激的
gratitude	感謝；感激之情
grave	嚴重的；墳墓；墓穴
greasy	油膩的
grease	油脂
greeting	問候；賀詞
grief	極度悲傷
grieve	悲痛
grind	磨碎
guarantee	保證；保證書
guilt	犯罪；罪惡感
guilty	有罪的；內疚的
gulf	海灣；鴻溝
habitual	習慣性的
halt	停止
handwriting	字跡
harden	使變硬；使冷酷無情
hardship	苦難
hardware	五金；硬體設備
harmonica	口琴
harmony	調和；和諧
harmonious	和諧的
harsh	粗糙的；嚴厲的
haste	急忙
hasten	催促；加速
headphone(s)	耳機
healthful	有益健康的
helicopter	直升機
herd	(人、動物)群集；成群移動
hesitation	猶豫
highly	非常地；高高地；強烈地
honeymoon	蜜月
honorable	值得尊敬的；隆重的
hook	用勾掛住；掛勾
hooked	著迷的
hopeful	有希望的；抱著希望的
horizon	地平線；視野
horizontal	地平線的；水平線的
horrify	使恐懼
horrified	驚懼的
horrifying	使人驚懼的
hose	用水管澆水；橡皮水管
host	招待客人；主持人；主辦國
hostel	招待所
household	家人；家庭；家務的
householder	一家之主
housewife	家庭主婦
housework	家事
humanity	人類；人性
humidity	濕度
hurricane	颶風
hydrogen	氫
iceberg	冰山
identical	同樣的
identification/ID	辨認；辨認之物
identify	辨別；有同感
idiom	慣用語；語法
idle	遊手好閒的；無用的
idol	偶像
ignorant	無知的
illustrate	說明；用例子證明
illustration	例子；插圖
imaginable	可想到的
imaginary	虛構的；想像的
imaginative	富有創意的
imitate	模仿
imitation	模仿；仿造品
immigrant	移居者
immigrate	移居而來
immigration	移居
impact	衝擊
imply	暗示；含有...意思
implication	暗示；含意
impression	印象
incident	事件
including	包括
indication	指示；暗示
industrialize	使工業化
infant	嬰孩
infancy	幼兒期
infect	感染
infection	感染；傳染病
infectious	感染的
inflation	通貨膨脹
influential	有影響力的
information	資訊；情報；知識
informative	給予知識的
ingredient	材料；成份
initial	最初的；開頭的字母
innocence	無罪；清白
input	輸入
insert	插入
inspection	檢查
inspiration	鼓舞；靈感
inspire	鼓舞；激發
inspiring	激勵的
install	安裝；安頓；使就任
instinct	直覺；天份
instinctive	本能的
instruct	教導；指示
instructor	講師；教師
insult	侮辱
insurance	保險
insure	投保
intellectual	有智慧的；知識份子
intellect	智能；智者；知識份子
intelligence	智能
intelligent	聰明的
intend	意圖，打算
intended	預定的；故意的
intention	意圖
intense	強烈的；激烈的
intensify	變強烈
intensity	強烈；強度
intensive	集中的
interact	互動
interaction	互動
interfere	妨礙；干涉
interference	妨礙；干涉
intermediate	中級程度的；中間的
Internet/internet	網際網路
interpret	解釋；口譯；翻譯
interpretation	說明；口譯
interpreter	口譯者
interruption	妨礙；中斷
intimate	精密的；精通的；私下的
intimacy	親密；熟悉
intonation	音調；抑揚
invade	侵略；侵犯
invasion	侵略；侵犯
invention	發明
invest	投資；授予
investment	投資
investigation	調查
involve	投入；意味；包含
involvement	捲入；牽扯
isolate	使孤立；使隔離
isolated	被隔離的
isolation	孤立；隔離
itch	癢；渴望
itchy	癢的
jealousy	嫉妒；猜忌
junior	年少的；下級的；大學三年級
keen	銳利的；熱心的；敏銳的；激烈的
keenly	銳利地；激烈地；熱心地
keenness	銳利；激烈；熱心
knuckle	指關節
labor	勞動；勞力；辛勞工作
laborer	勞工
laboratory/lab	實驗室
lag	延遲；落後
largely	大部分地
lately	近來；最近
launch	(船)下水；(火箭)發射
lawful	合法的
lead	鉛
leaded	有鉛的
lean	倚靠；瘦的；無脂肪的
learned	有學問的；精通的
lecture	演講；講課；教訓
lecturer	演講者；講師
legend	傳說：傳奇人物
legendary	傳說的；有名的
leisurely	悠閒的；從容的
license	執照；許可證
lighten	減輕
limitation	限制
liquor	烈酒
literary	文學的
literature	文學
loan	借貸；貸款
location	位置
locker	(可上鎖的)儲物櫃
logic	邏輯
logical	合理的；合乎邏輯的
lotion	化妝水；乳液
lousy	討厭的；情況極壞的
loyal	忠實的，忠誠的
loyalty	忠實
loyally	忠實地
lunar	月球的
luxurious	豪華的
luxury	奢侈；奢侈品
machinery	機器
madam/ma'am	太太；女士
magnetic	帶有磁性的；具有吸引力的
magnificent	壯觀的；極佳的
magnificently	壯觀地；極佳地
magnificence	壯觀；極好
manual	手工做的；肉體的；手冊
manufacture	製造
manufacturer	製造商
marathon	馬拉松賽跑
margin	(書頁的)空白處
maturity	成熟
maximum	最大限度；頂點
mechanic	機械工
mechanical	機械的；機械化的
mechanically	機械化地
memorable	令人難忘的；值得記念的
memorably	令人難忘地；值得記念地
memorial	紀念的；追悼的；紀念物；紀念碑
mercy	慈悲；憐憫
mere	僅僅的
merely	僅僅，只
merit	優點
messenger	信差
messy	凌亂的；棘手的；麻煩的
microscope	顯微鏡
mild	溫和的
mildly	溫和地
minimum	最小限度；最小值
minister	部長；牧師
ministry	(內閣的)部
mischief	惡作劇；淘氣
mischievous	惡意的；搗蛋的
mischievously	惡意地；惡作劇地
miserable	悲慘的；不幸的，可憐的
miserably	悲慘地
misfortune	厄運，不幸；變故，災難
mislead	誤導
misleading	易招致誤解的；引入歧途的
misunderstand	誤解，誤會
misunderstanding	誤會
moderate	中等的，適度的；普通的；溫和的
modest	樸素的；謙虛的；端莊的；適度的
modestly	謙虛地；端莊地
modesty	謙虛；端莊；適度
monitor	監視器；螢幕；監督
monthly	每月的；月刊
monument	紀念碑；紀念物；遺跡
moreover	而且
mostly	主要的；大半
motivate	引起動機
motivation	動機；誘因
motive	動機；目的
mountainous	多山的
muddy	泥濘的
multiple	多樣的；多數的
multiply	乘；增加
murderer	殺人犯
murmur	低語聲；低聲的抱怨
mustache	(長在嘴巴上方的)鬍子
mutual	互相的
mutually	相互地
mysterious	神秘的；原因不明的
mysteriously	神秘地
namely	即；換言之
nationality	國籍
nearsighted	近視的
needy	貧窮的
neglect	忽略；疏忽
negotiate	談判；協商
negotiation	商議；談判
nevertheless/nonetheless	可是，仍然
nightmare	惡夢，夢魘
nonsense	廢話；無用的東西
noun	(文法)名詞
nourish	養育；懷有
nourishing	營養豐富的
nourishment	營養
nowadays	現在；現今
nuclear	核子的；核子武器的
nucleus	核心；原子核
numerous	許多的
nursery	托兒所；育嬰室；苗圃
nylon	尼龍；尼龍襪
obedience	服從
obedient	聽話的；服從的
obediently	服從地
objection	反對
objective	客觀的；目標
observation	觀察；評論
obstacle	阻礙
obtain	獲得
occasional	偶爾的
occasionally	偶爾
occupation	職業；消遣
occupy	占據；擁有；使專心於...
occupied	有人的；專心於...；忙著...
offend	激怒；冒犯
offense	冒犯；違反；犯罪；攻擊
offensive	攻擊的；無禮的；令人不愉快的
offensively	無禮地
opera	歌劇
operation	工作；操作；手術
oppose	反對
orbit	軌道；延軌道運行
orchestra	管弦樂團
organic	有機的
organically	以有機肥料栽種地
otherwise	否則
outcome	結果
outstanding	傑出的，顯著的
oval	橢圓形的；橢圓
overcome	克服；打敗；征服
overlook	忽略；漏看；俯瞰
overnight	一整夜；一夕之間，忽然
overtake	追上並超過；(災難)突然襲擊
overthrow	推翻；廢除
oxygen	氧氣
pace	步伐；踱步
panel	嵌板；討論小組
parachute	降落傘；跳傘
partial	部分的；偏心的
participation	參加
participle	(文法)分詞
partnership	合作；合夥關係
passive	被動的；消極的
pasta	義大利麵
pebble	小石子
peculiar	奇怪的；獨特的
peculiarly	奇怪地；特別地
pedal	(腳踏車的)踏板；踩踏板
peer	同儕
penalty	刑罰；處罰；不利之處
percent/per cent	百分之...
percentage	百分比
perfection	完美
perfume	香水；(花的)香味
permanent	永久的；燙髮
permanently	永久地
persuasion	說服
persuasive	有說服力的
persuasively	有說服力地
pessimistic	悲觀的
petal	花瓣
phenomenon	現象
philosopher	哲學家
philosophical	哲學的；豁達的
philosophy	哲學；人生觀
philosophically	豁達地
photography	攝影
physical	身體的
physically	身體上
physician/doctor	(內科)醫生
physicist	物理學家
physics	物理學
pianist	鋼琴家
pickpocket	扒手
pilgrim	朝聖者；進香客
pioneer	拓荒者；先驅
pirate	海盜；盜版
piracy	盜版
plentiful	豐富的；充足的
plot	(故事的)情節；陰謀；標出位置
plural	複數的
p.m./pm/P.M./PM	下午；午後
poisonous	有毒的；充滿惡意的
polish	擦亮；光澤
pollution	汙染
popularity	受歡迎；流行
portable	手提式的，可攜帶的
porter	搬運工
portray	描繪
possess	擁有
possession	擁有
possessions	財產
poultry	家禽；家禽的肉
precise	精確的
precisely	精確地；正好
precision	精確
predict	預測
prediction	預測
predictable	可以預測的
preferable	更好的
preference	偏好
pregnancy	懷孕
pregnant	懷孕的
preposition	介係詞
prepositional	介係詞的
presentation	贈送；演出；發表
preservation	保護；維護
preserve	維持；保護區
preservative	防腐劑
prevention	預防；阻止
prime	首要的；最好的；質數的
primitive	原始的；初期的
privacy	隱私；私下，秘密
privilege	特權；特殊待遇
privileged	擁有特權的
procedure	手續
proceed	開始著手進行；(暫停後)繼續進行
production	生產；製作
productive	有生產力的；多產的
profession	職業；專業
professional	職業的；專業人員
professor	教授
profitable	賺錢的；有利可圖的
prominent	突出的；顯著的；著名的
prominently	突出地；顯著地
promising	有前途的
promotion	促銷；提升
prompt	迅速的；立即交付的
promptly	迅速地
pronoun	代名詞
pronunciation	發音
prosper	繁榮，興盛
prosperity	繁榮；昌盛
prosperous	繁榮的；順利的
protein	蛋白質
protest	抗議，反對
proverb	諺語
psychological	心理上的
psychologist	心理學家
psychology	心理學
publication	出版刊物
publicity	公開；出名；宣傳
publish	出版；發表
publisher	出版商
punctual	準時的
punctually	準時地
pursuit	追趕；追求
quake	震動；發抖；地震
quilt	棉被
quotation	引用的文字
rage	憤怒；激烈；生氣
realistic	現實的；實際的
rebel	叛逆者；反抗者
recall	想起；召回；收回
reception	接收；接待；招待會
receptionist	接待員
recipe	食譜
recite	背誦；詳細講述
recital	詳述；獨奏(獨唱)會
recognition	辨認；承認
recovery	取回；康復
recreation	娛樂；消遣
recycle	再生利用
reduction	減少；折扣
refer	派遣；委託；提及
reference	證明文件；推薦函；參考文獻
reflect	反射；反映；反省；仔細思索
reflection	反射；映像；感想
reform	改革；修正
reformation	改革；修正；改善
refreshment	點心
refugee	難民
refuge	保護；避難；避難所
refusal	拒絕
regarding	關於
register	註冊；登記；記錄簿
registration	登記；註冊
regulate	管制；調節
regulation	規則
rehearse	預演
rehearsal	預演；排演
rejection	拒絕
relative	親戚；有關的；比較上的
relatively	相對地；比較上
relaxation	放鬆；鬆懈；消遣活動
relieve	減輕；解除；使...放心
reluctant	不情願的
reluctantly	勉強地
remark	意見；短評
remarkable	顯著的
remarkably	顯著地；非常
remedy	補救辦法；治療法
repetition	重複；反覆
representation	代表；代表權
reputation	名聲；名譽
rescue	救援；拯救，救出
research	研究
researcher	研究員
resemble	像，與...相似
reservation	預訂
resign	辭職
resignation	辭職；辭職信
resistance	抵抗
resistant	有抵抗力的；抗拒的
resolution	決心；解決
resolve	決心；解決
respectable	可敬的；得體的
respectably	高尚的；得體地
respectful	恭敬的
respectfully	恭敬地；有禮地
restore	恢復
restriction	限制
retain	保存
retreat	撤退；退出
reunion	團聚
reunite	使...重聚
revenge	復仇；報復
revise	修訂；修正
revision	修訂版；複習
revolution	革命；迴轉
revolutionary	革命的；革命性的
reward	獎賞；報酬；獎金
rhyme	押韻；韻文
rhythm	韻律，節奏
romance	戀史；傳奇
romanticism	浪漫主義
roughly	粗魯地；大致上
route	路線
ruin	毀壞；遺跡
rural	鄉村的
sacrifice	犧牲
salary	薪水
salesperson/salesman/saleswoman	推銷員；門市人員
satellite	衛星
satisfaction	滿意
scarcely	缺乏地；幾乎不；僅僅，勉勉強強地
scenery	風景
scold	責罵
scratch	搔抓
screwdriver	螺絲起子；螺絲起子雞尾酒
sculpture	雕塑；雕塑品
seagull/gull	海鷗
senior	年長的；資深的
seniority	年長；資深
settler	殖民者
severe	嚴厲的，嚴格的；嚴肅的
severely	嚴厲地
shameful	可恥的；無恥的
shameless	不知羞恥的
shaver	剃削的工具
shelter	保護，庇護；躲避
shift	移動；轉移；交替
shortsighted	近視的；沒有先見之明的
shrug	聳肩
shuttle	交通車；往返
sightseeing	觀光
signature	簽名
significance	重要；意義
sincerity	誠意
singular	單數的；與眾不同的
site	位置；遺跡
sketch	素描；概要
slight	輕微的；少量的；苗條的
slogan	口號；標語
smog	煙霧
sneak	偷偷地進入；偷偷帶出
sneaky	偷偷摸摸的
sneaker	(膠底)運動鞋
sneeze	打噴嚏；噴嚏
sob	啜泣；啜泣聲
socket	插座；插頭；眼窩
software	軟體
solar	太陽的
sorrowful	傷心的
souvenir	紀念品
spare	抽出；空閒的；備用品
spark	發出火花；引起；火花
sparkle	閃閃發光；閃耀
sparrow	麻雀
spear	用矛(或魚叉)戳刺；矛；魚叉
species	(生物分類)種
spicy	辛辣的
spiritual	精神上的；心靈的
splendid	壯麗的
split	劈開；分裂
sportsman	運動員
sportsmanship	運動家精神
status	地位；狀態
stem	起源於；(植物的)莖幹
stingy	吝嗇的
strengthen	增強
strive	努力；奮鬥
stroke	撫摸；中風；(游泳的)一划；一筆畫
suggestion	建議
suggestive	暗示的
summarize	概述
surf	衝浪；海浪
surgeon	外科醫生
surgery	外科手術
surrender	放棄；投降
surroundings	環境
suspicious	懷疑的
syllable	音節
sympathetic	富有同情心的；贊同的
sympathy	同情
sympathize	同情；有同感
symphony	交響樂
syrup	糖漿
systematic	有系統的
technician	技師
technological	科技的
telegram	電報
telegraph	電訊；電報
telescope	望遠鏡
tendency	傾向；性向
tense	緊張的；緊繃的；時態
tension	緊張狀態
terrify	驚嚇
terrifying	嚇人的
terror	恐懼
terrorism	恐怖主義
terrorist	恐怖分子
theme	主題
thorough	完全的；細心周到的
thoroughly	完全地；細心地
thoughtful	周到的；體貼的
timid	膽怯的
tiresome	煩人的
tolerable	可容忍的；尚可的
tolerance	抵抗力
tolerate	容忍
tolerant	寬容的；寬大的
tomb	墳墓
tough	堅韌的；難纏的
tragedy	悲劇
tragic	慘痛的
transfer	轉移；調任
transform	改變；性質
translate	翻譯
translation	翻譯；譯本
translator	翻譯者；口譯人員
transportation	交通工具；運輸
tremendous	巨大的；驚人的
triumph	大勝利；獲得勝利
troublesome	令人討厭的；棘手的
tug-of-war	拔河
twinkle	閃爍
typist	打字員
underline	劃底線
underpass	地下道
unique	獨一無二的
universal	普遍的；全宇宙的；全世界的
university	大學
upload	上傳
urban	都市的
urge	驅使；衝動
urgent	緊急的；強行要求的
urgency	緊迫；強行要求
usage	使用；用法
vain	無益的；白費的；自負的
vast	廣大的；浩瀚無邊的
vegetarian	素食者
verb	動詞
very	正是
vessel	脈管
violate	違反；侵犯
violation	違反的行為
virgin	處女；首次的；純潔的；未開發的
virtue	美德；優點；長處
virus	電腦病毒
visual	視力的，視覺的
vital	維生的；不可或缺的
volcano	火山
voluntary	自願的
volunteer	志工
vowel	母音
voyage	航行
waterproof	防水的
website	網站
weekly	每週的
welfare	福利；社會福利
wit	智慧；機智
witch/wizard	女巫
withdraw	抽出；提款；撤退
withdrawal	抽出；提款；撤退
witness	目擊證人；作證
wrinkle	起皺紋；皺紋
yearly	一年的
yogurt	優酪乳
youthful	年輕的
zipper	拉鍊
