aboard	搭乘；上車
acceptable	可接受的
account	帳戶；解釋
accurate	精確的
accurately	精確地
ache	疼痛；渴望
achieve	完成；獲得
achievement	成就
activity	活動；活力
actual	事實上的
actually	實際上
additional	附加的
additionally	此外
admire	讚美；欽佩
admit	承認；允許入場
adopt	採用；收養
adoption	採用；收養
advanced	先進的；高級的
advantage	益處
advantageous	有利的
adventure	冒險
adventurous	冒險的
adventurer	冒險家
advertise	做廣告
advertiser	登廣告者
advice	忠告；建議
advise	勸告
adviser/advisor	忠告者
affect	影響
afford	負擔得起
affordable	負擔得起的
afterward(s)	之後
agriculture	農業
agricultural	農業上的
air-conditioner	空調設備
air-conditioned	有空調的
alley	小巷子；(保齡球)球道
amaze	使吃驚
amazed	驚愕的
amazing	令人驚訝的
amazingly	令人吃驚地
amazement	驚訝
ambassador	大使
ambition	雄心
ambulance	救護車
angel	天使
angle	角度；看法
announce	宣布；顯露
announcement	公布
announcer	宣布者；播報員
apart	分開地
apparent	顯露的；表面的
apparently	明顯地；表面上
appeal	懇求；有吸引力
appealing	懇求的；有魅力的
appointment	任命；官職；約定
appreciate	感謝；欣賞
approach	靠近；著手從事；處理方式
approve	同意；認可
aquarium	水族館
arrival	到達
ash	灰；骨灰
aside	在旁邊
assist	幫助
athlete	運動員
attempt	嘗試；試圖
attitude	態度；意見
attract	吸引；引起
attractive	迷人的
audience	觀眾
author	作者
automatic	自動的
automobile	汽車
available	可利用的；有空的
avenue	大道；手段
average	平均；普通的
awake	醒著的；醒來
awaken	喚起
award	授予；頒發；獎品；獎金
aware	注意到
awful	恐怖的；極討厭的
awfully	極其地
ax/axe	斧頭
background	背景；經歷
bacon	培根肉
bacteria	細菌
badly	壞地；非常地
baggage	行李
bait	裝誘餌；餌
balance	使平衡；衡量；餘額
bandage	繃帶
bang	砰
bare	裸的
barely	勉強地
barn	穀倉
barrel	木桶
bay	海灣
beam	光線
beast	野獸
beggar	乞丐
behave	舉止；舉止檢點
being	存在物；存在
beneath	在...的下方；比...差
benefit	受益；利益
berry	莓果
Bible/bible	聖經
billion	十億
bingo	賓果遊戲；答對了
biscuit	比司吉；餅乾
blame	責怪；歸咎於
blanket	毛毯
bleed	流血
bless	祝福；保佑
blouse	(女用)襯衫
bold	大膽的
boot	靴子
border	邊界；鑲邊於
bore	使厭煩；討厭的人或事
brake	剎車
brass	黃銅；銅管樂器
bravery	勇敢
breast	乳房；胸部
breath	呼吸；一次呼吸
breathe	呼吸
breeze	微風；容易的事
bride	新娘
brilliant	燦爛的；傑出的
brook	小河
broom	掃帚
bubble	泡沫
bucket	水桶；大量
bud	新芽；花蕾；發芽
budget	預算；編預算
buffalo	水牛
buffet	歐式自助餐
bulb	電燈泡
bull	(未閹割的)公牛
bullet	子彈
bump	碰撞
bunch	串；束
burden	負荷物；成為...的負擔
burglar	竊賊
bury	埋葬；掩住
bush	灌木
buzz	嗡嗡響
cabin	小屋；船艙
cane	拐杖；藤條
canoe	(用槳划的)小船；以小船運送
canyon	峽谷
capable	有能力的
capability	能力
capital	大寫的；主要的
capture	捕獲；獲得
carpenter	木匠
carriage	馬車；嬰兒車；搬運
cast	投擲；鑄造；角色
casual	隨便的；非正式的；意外的
caterpillar	毛蟲
cattle	牛
celebration	祝賀；慶祝會
centimeter	公分
chain	連鎖店；鎖鏈
challenge	挑戰
challenging	具挑戰性的
champion	優勝者
changeable	善變的
channel	海峽；頻道；傳送
chapter	章節；時期
charm	魅力；美貌；迷惑
charming	迷人的
chat	聊天；閒談
cheek	臉頰
cheer	歡呼；喝采
cheerful	開朗的；快樂的
cheese	乳酪
cherry	櫻桃
chest	胸部；大箱子
chew	嚼
childhood	童年
chilly	冷的
chimney	煙囪
chip	碎片；洋芋片；削
chirp	鳥、蟲叫聲
choke	窒息；使堵塞
chop	砍；厚肉片
cigarette	香菸
cigar	雪茄
circus	馬戲團
classical	古典的
click	喀啦響
client	委託人；顧客
clip	剪報；迴紋針
clue	線索
cocktail	雞尾酒
coconut	椰子
collar	衣領
collection	收集
college	學院；大學
colony	殖民地
column	圓柱；縱列；專欄
combine	使結合
comfort	安慰；鼓勵
comma	逗號
command	命令；要求
commercial	商業的；廣告
committee	委員會；委員
communicate	傳播；通知；溝通
comparison	比較
compete	競爭
complaint	抱怨
complex	複雜的；情結
concern	關心；擔心
concert	音樂會
conclude	結束；下結論
conclusion	結論
condition	狀況；條件
cone	圓錐筒；冰淇淋甜筒
confident	自信的
confidence	信任；自信；秘密
confuse	使混淆
confused	混亂的
confusing	令人困惑的
connect	連接；聯絡；與...有關
connection	連接；關係
conscious	意識到
consciousness	意識
considerable	大量
consideration	考慮；體諒
constant	穩定的；不間斷的
constantly	不斷地
contest	競爭；比賽
continent	大陸
contract	契約；簽約
couch	長沙發
countable	可數的
coward	膽小鬼
cowardly	膽小的
cozy	舒適的
cradle	搖籃；搖
crash	碰撞；墜落
crawl	爬行；緩慢地前進
creative	有創造力的
creator	作者
creature	生物；傢伙
credit	信任；相信
creep	爬；悄悄來到
crew	全體船員；(一組)工作人員
cricket	蟋蟀；板球
criminal	犯人
crisp/crispy	酥脆的
crown	王冠；榮譽；加冕
cruelty	殘忍；殘忍的行為
crunchy	(咀嚼時)嘎吱作響的
crutch	拐杖
cultural	文化的
cupboard	櫥櫃
cycle	週期；腳踏車
dairy	酪農場；乳製品
dam	水壩；用堤壩攔住
dare	膽敢
darling	親愛的
dash	猛衝；破折號
decade	十年
deck	甲板
define	給...下定義
definition	定義
delivery	運送；分娩
democracy	民主；民主國家
democratic	民主的
deposit	存款；押金
description	描述
designer	設計師
destroy	毀壞
destructive	破壞性的
detail	細節，項目
determine	決定
determined	意志堅定的
devil	魔鬼
dialogue	對話；對白
diet	日常飲食；節食
diligent	勤勉的
dim	昏暗的；模糊不清的
dime	一角硬幣
dine	用餐
dip	浸泡
dirt	塵土
disappoint	使失望
disappointed	失望的
disappointing	使人失望的
disappointment	失望
disco/discotheque	迪斯可舞廳
discount	打折扣
discovery	發現
disease	疾病
diseased	生病的
dislike	討厭
ditch	溝；下水道
dive	潛水；跳水
dock	碼頭
dodge	閃躲；蒙混
domestic	家庭的；國內的
dose	配藥
doubtful	感到懷疑的
drain	排出；下水道；消耗體力
dramatic	戲劇性的
drip	滴下；水滴
drown	淹死；淹沒
drowsy	昏昏欲睡的
drunk	醉的；醉漢
due	到期的；會費
dump	傾倒；垃圾場
dust	灰塵
eager	渴望的；熱心的
earnings	所得；工資；利潤
echo	發出回音；附和
edit	編輯
edition	版本
editor	編輯
editorial	社論
educate	教育
educated	有教養的
educational	教育的
efficient	有效率的
efficiently	有效率地
elbow	手肘
elderly	年長的
election	選舉
electric/electrical	電的
electricity	電力
electronic	電子的
electron	電子
emergency	緊急情況
emperor	皇帝
emphasize	強調
employ	雇用
employment	雇用
employee	受雇人員
employer	雇主
empty	空的
enable	使...能夠
energetic	精力充沛的
engage	從事；訂婚
engaged	忙碌的；占線；訂婚的
engagement	約會；訂婚
engine	引擎
engineer	工程師
enjoyable	有趣的
entry	進入；入口
environmental	環境的
envy	忌妒
erase	抹去；除去
escape	脫逃
essay	小品文
evil	邪惡的
excellence	優秀
exchange	交換
exhibition	展示；展覽
existence	生存
exit	出去；退場；出口
expectation	期望
expend	花費
expense	開支；費用
experiment	實驗
explode	爆炸；情緒爆發
export	出口；出口物品
expression	表示；表情
extreme	極度的；極端
extremely	非常地
fable	寓言
factor	因素
fade	褪色；衰退
faint	暈倒；微弱的
fairly	公平地
fairy	仙女；精靈
faith	信任；信仰
fake	偽造；贗品
familiar	熟悉的
familiarity	熟悉
fan	搧；激起
fancy	幻想；精緻的
fare	票價
farther	更遠地
fashion	方式；流行
fashionable	流行的；高級的
fasten	固定；繫牢
fate	命運
faucet	水龍頭
fax	傳真
feather	羽毛
feature	特色；特徵
file	歸檔；檔案
firework	煙火
fist	拳；拳頭
flame	火焰；熱情
flavor	味道；增添風味
flea	跳蚤
flesh	肉品
float	漂浮；浮板
flock	群集
fold	摺疊；摺痕
folk	人們；家屬；民俗的
follower	信徒
fond	有感情的；盲目溺愛的
forehead/brow	前額
forever	永久地
forth	向前；外出
fortune	運氣；財富
found	創立
fountain	噴泉；泉源
freeze	結冰
frozen	結冰的
frequent	頻繁的
frequently	經常地
friendship	友誼
frustrate	使受挫
frustrated	感覺受挫的
frustrating	令人沮喪的
fry	油炸
fund	資助；募款；公債
fur	毛
furry	軟毛的
furniture	家具
gallon	加侖
gamble	冒險；賭注
gang	一群；幫派
gap	裂縫；隔閡
garlic	大蒜
gasoline/gasolene/gas	汽油
gesture	手勢；示意
glance	匆匆一瞥
global	全球的
glory	光榮；壯麗
glow	灼熱；發光
gossip	散布謠言
governor	州長；地方首長
gown	禮服
grab	抓取
gradual	逐漸的
gradually	逐漸地
graduate	畢業；畢業生
grain	穀物
gram	公克
grasp	抓牢；理解
greenhouse	溫室
grin	露齒一笑
grocery	雜貨店
grocer	雜貨商
guardian	保護者；監護人
guidance	引導
gum/chewing gum	橡膠；口香糖；牙齦
gymnasium/gym	體育館；體育
handful	少數
handy	便利的；靈巧的
harbor	港；避難所
harm	傷害
harmful	有害的
harvest	收割；成果
hasty	急忙的；輕率的
hatch	孵化
hawk	鷹；叫賣
hay	乾草
headline	報紙標題
headquarters	總部
heal	治癒
heap	堆；許多
heaven	天堂；天空
heel	腳跟
hell	地獄
helmet	安全帽
hesitate	猶豫
hike	遠足；健行
hint	暗示；提示
historian	歷史學家
historic	重要的；歷史悠久的
historical	歷史的
hive	蜂房；人群嘈雜之處
hollow	中空的；不實的；洞穴
holy	神聖的
honesty	誠實
honor	尊敬；榮譽
horn	角；喇叭
horrible	可怕的；糟糕的
horror	恐懼
hourly	每一小時的
hug	擁抱
humorous	有幽默感的
hush	使安靜；靜寂
hut	小屋
icy	冰的；極冷的
ideal	理想的；想像的
identity	身分；一致
ignorance	無知
image	肖像；象徵
imagination	想像力
immediate	直接的；立刻的
immediately	立刻；直接地
import	進口；進口物品
impress	使銘記；使有深刻的印象
impressive	印象深刻的
indeed	確實地
individual	個人；個別的
indoor	室內的
indoors	室內地
industrial	工業的
inferior	下級的；次等的；部下
inferiority	低劣；下位
inform	通知
injure	損害；受傷
injured	受傷的；傷患
injury	損害；受傷
inn	旅店
inner	內部的
innocent	無罪的；天真的
inspect	檢查
inspector	檢查者
instead	取而代之，反而
instruction	教導；指示
internal	內部的
interrupt	打斷；阻礙
introduction	介紹；導論，前言
inventor	發明家
investigate	調查
ivory	象牙色的；象牙
jail	拘留；監獄
jar	瓶子；刺耳的聲音
jaw	顎
jealous	忌妒的；猜忌的
jealousy	忌妒；猜忌
jelly	果凍
jet	噴出；噴射飛機
jewel	寶石；首飾；寶貝的人或物
jewelry	珠寶首飾
journal	日記；日誌；定期刊物
journalist	新聞業者
journey	旅行；行程
joyful	喜悅的
jungle	叢林
junk	廢棄物
justice	正義；公正
kangaroo	袋鼠
kettle	水壺
keyboard	鍵盤
kidney	腎臟
kilogram/kg	公斤
kilometer/km	公里
kit	成套用具
kneel	跪下
knight	授予...爵位；爵士
knit	編織
knob	圓形的門把
knot	結；打結
label	標籤；歸類
lace	花邊；鞋帶
ladder	梯子
latter	後者的
laughter	笑；笑聲
laundry	洗衣店；待洗衣物
lawn	草坪
leak	洩漏
leap	跳躍
leather	皮革
leisure	閒暇
lengthen	加長；使變長
lens	透鏡
liar	說謊的人，騙子
liberal	自由的；無偏見的；慷慨的
liberty	自由
librarian	圖書館館員
lifetime	一生
lighthouse	燈塔
limb	手腳（的一肢）
linen	亞麻，亞麻布
litter	垃圾；一胎所生之動物
lively	活潑的；輕快的；愉快的
liver	肝臟
load	負荷；把貨物裝上；裝填子彈
loaded	裝滿東西的；裝了子彈的
lobby	旅館的大廳
lobster	龍蝦
lollipop	棒棒糖
loose	鬆的
loosely	鬆散地
loosen	放鬆
lord	主人；貴族
loudspeaker	擴音器
luggage	行李
lullaby	催眠曲，搖籃曲
lung	肺臟
magical	像魔法般的
magnet	磁鐵；磁石
maid	女僕；少女
major	主要的；主修科目
majority	大多數
makeup	化妝品
mall	購物中心
manage	管理；經營
management	經營；管理
manager	經理
mankind	人類
manners	禮貌
well-mannered	有禮貌的
ill-mannered	無禮的
marble	大理石彈珠
march	遊行；列隊行進；進行曲
marvelous	令人驚嘆的；很棒的
marvel	令人驚奇的事；對...感到驚奇
mathematical	數學的
mathematics/math	數學
mature	成熟的；長成；成熟
mayor	市長；鎮長
meadow	牧草地
meaningful	有意義的
meaningfully	有意義地
meanwhile	同時；目前
medal	獎章
medical	醫學的；醫藥的
medium/media	媒介；中等
melt	融化
membership	會員資格
memorize	熟記
mend	修補；改正
mental	精神的；智力的
mentally	精神上；智力上
mention	提及，提到
merchant	商人
merry	快樂的
merrily	快樂地
merriment	快樂；笑鬧
mess	雜亂；困境；弄髒
microphone/mike	麥克風
microwave	微波
might	可能；可以
mighty	強而有力的，強大的
might	力量
mightily	強力地；非常
mill	磨坊；麵粉廠；磨成粉
millionaire	百萬富翁
miner	礦工
mineral	礦物
minor	次要的；未成年人
minority	少數；少數民族
miracle	奇蹟
miraculous	奇蹟似的
miraculously	不可思議地
misery	悲慘
missile	飛彈
missing	失蹤的；缺少的
mission	使命，任務
mist	霧
misty	有霧的；模糊不清的
mixture	混合物；交錯
mob	暴民；烏合之眾
mobile	可以移動的
moist	潮濕的
moisture	濕氣；水分
monk	修道士；僧侶
mood	心情
mop	拖把；用拖把拖
moral	道德的
morally	道德上
motel	汽車旅館
motor	馬達；發動機
murder	殺人；謀殺；凶殺案
muscle	肌肉
mushroom	蘑菇；蕈；如雨後春筍般增長
musical	音樂的；音樂劇
mystery	神秘；奧秘
nap	小睡，打盹
native	本地的；原產的；天生的；當地居民；當地產物
navy	海軍
necessity	需要；必需品
necktie	領帶
neighborhood	附近地區
nerve	神經；勇氣
nervous	緊張的
nervously	緊張地
network	網狀組織
nickname	綽號，別名；暱稱
noble	高貴的；高尚的；貴族
normal	正常的
normally	通常
novelist	小說家
nun	修女；尼姑
oak	橡樹
observe	觀察；遵守；評論
obvious	明顯的
obviously	顯然
occasion	時候；場合；機會
odd	奇怪的；奇數的；偶爾的
oddly	奇怪地
odds	勝算；可能性
onto	到...上
operator	接線生
opportunity	機會
opposite	相反的；對面的
optimistic	樂觀的
origin	起源；源頭
original	最初的；原作
originally	原來；本來
originality	獨創性，創造力
orphan	孤兒
orphanage	孤兒院
ought to	應該
outdoor	戶外的
outdoors	在戶外
outer	外面的；遠離的
outline	輪廓；大綱
overcoat	大衣
owe	欠；歸功於
ownership	所有權
pad	襯墊；便條本子；填塞
pal	朋友；夥伴
palace	皇宮，宮殿
pale	蒼白的
pancake	薄煎餅
panic	恐慌
parade	遊行
paradise	天堂；樂園
parcel	包裹
participate	參加
passage	一段（文章）；道路；通過
passion	熱情；熱愛
passport	護照
password	暗語；密碼
patience	耐心；忍耐力
pause	暫停
pave	鋪路
pavement	人行道
paw	（貓狗的）腳掌
pea	豌豆
peak	山頂；頂點
pearl	珍珠
peel	（蔬菜、水果的）外皮；削皮
peep	偷看
penny	一分錢
perform	執行；表演
performer	表演者；執行者
performance	表現
permission	許可；許可證
permit	許可證；許可
personality	個性；人格
persuade	說服；使確信
pest	害蟲；令人討厭的人
pickle	酸黃瓜，泡菜
pill	藥丸
pilot	飛行員；引導
pine	松樹
pint	品脫（= 0.55 公升）
pit	坑洞；果核
pity	遺憾；同情
pitiful	可憐的
plastic	塑膠的；塑膠
plenty	大量，許多
plentiful	豐富的，充足的
plug	插頭；塞子；栓
plum	李子
plumber	水管工人
pole	棒，柱；（南北）極
political	政治的
politically	政治上
politician	政客；從政者
politics	政治；政治學
poll	投票；民意調查
pollute	汙染
pony	小型馬
pop	啪的一聲；突然做...；流行的
portion	一部分
portrait	肖像
portray	描繪
postage	郵資
poster	海報
postpone	延期
postponement	延期
pottery/ceramic(s)	陶器類
pour	倒（水）；（雨）傾盆而下
poverty	貧窮
powder	粉末
practical	實際的；實用的
practically	實際上
prayer	禱告；禱文
precious	珍貴的
preparation	準備
pressure	壓力
pretend	假裝
prevent	阻止；預防
previous	先前的；預先的
previously	先前；預先
priest	牧師，祭司
primary	最重要的；最初的
primarily	主要地
probable	有可能的
probably	大概；可能
probabilily	可能性
process	過程；方法；加工處理
product	產品
profit	收益；獲利
promote	促銷；促進；提升
proof	證據；證物；耐...的
proper	適當的；正確的
properly	適當地；正確地
property	性質，屬性；財產
proposal	提議
protection	保護
protective	防護的；保護的
protectively	保護地
pub	酒館
punch	一拳；打孔
pure	純淨的；完全的
purely	純淨地；完全地
pursue	追趕；追求
quarrel	吵架
queer	古怪的；瘋狂的，不正常的
quote	引述；引用；估價；引號
racial	種族的
radar	雷達
rag	破布；破舊的衣服
raisin	葡萄乾
rank	等級；名列於
rate	比率；速度；評價
raw	生的；原始的；無經驗的
ray	（一道）光線；曙光
razor	刮鬍刀；剃刀
react	反應
reaction	反應
reasonable	合理的；公道的
reasonably	合理地
receipt	收據
receiver	(電話)聽筒；收件人
recognize	認出；承認；肯定
recorder	錄音機；錄影機
recover	取回；恢復
reduce	減少；縮小；使...陷入
refresh	喚起記憶；回復活力
regional	地區性的
regret	抱歉；遺憾；失望；後悔
regretful	遺憾的；後悔的
relate	使...有關聯；與...有關係
relax	放鬆；休息
release	釋放；上映；發售；發表
reliable	可靠的
relief	減輕；放心
religion	宗教，信仰
religious	宗教的；虔誠的
rely	依靠；信賴
remain	依舊是；剩下
remind	使...想起；提醒
remote	遙遠的；偏僻的；疏遠的
remotely	遙遠地；不密切地
remove	去除；移除；脫掉
renew	換新；重新開始
rent	房租；租金；出租
repair	修理
replace	放回；取代
replacement	取代
represent	代表；象徵
representative	有代表性的，典型的；代表
republic	共和國
request	要求
reserve	保留；預訂
reserved	預訂的；矜持內向的
resist	抵抗；抗拒
resource	資源
respond	回答；反應
response	回答；回應
responsibility	責任；職責
restrict	限制
retire	退休
retired	已經退休的
retirement	退休
reveal	顯露；洩漏
revelation	揭露
ribbon	緞帶
rid	免除；去除
riddle	謎語；不可理解的...
ripe	成熟的
risk	冒險
risky	危險的；碰運氣的
roar	吼叫；大叫
roast	烤(肉)；烘烤的
rob	搶劫
robber	強盜
robbery	搶劫；掠奪
robe	寬鬆的長袍；官服
rocket	火箭；火箭式煙火
romantic	浪漫的
rot	腐爛
rotten	腐爛的
rough	粗糙的；概略的
routine	例行公事；固定不變的
rug	小地毯
rumor	謠言
rust	生鏽
rusty	生鏽的
sack	大布袋
sake	緣故，理由
satisfactory	令人滿意的；充分的
saucer	茶托，淺碟
sausage	香腸
saving(s)	救助；節約；存款
scale	規模；刻度；等級；體重計；鱗片
scarce	缺乏的；稀有的
scarecrow	稻草人
scary	令人害怕的
scatter	散播
scattered	散播的
schedule	計畫表；進度
scholar	學者
scholarship	獎學金
scientific	科學的；正確的，嚴密的
scoop	勺子；獨家新聞
scout	童子軍；偵查
scream	尖叫
screw	螺絲；用螺絲固定
scrub	擦洗；用力擦洗
seal	封印；印章；海豹
secondary	中等的
security	安全；防禦
secure	安全的；確保
seek	尋找
seize	抓住
seldom	很少地
sensible	明智的；察覺到的；明顯的
sensitive	敏感的；在乎的
separation	分離；分居
sew	縫紉
sewing	裁縫
sex	性別；性
sexual	與性有關的
sexy	性感的；迷人的
sexism	性別歧視
shade	陰暗；陰涼處；遮光物
shadow	影子；陰影
shady	蔭蔽的；(樹木等)成蔭的
shallow	淺的；膚淺的
shame	羞愧；恥辱
shampoo	洗髮精
shave	剃；刮(鬍子等)
shepherd	牧羊人
shiny	閃耀的；發光的
shorten	縮短
shortly	不久，馬上；短暫地
shovel	鏟起；鏟子
shrink	縮水；減少
sigh	嘆氣
signal	發出信號；信號
significant	重要的；有意義的
similarity	相似
sin	罪惡；違背；犯罪
sincere	真誠的
sip	啜飲
situation	情況；立場
situate	位於
skate	溜冰；溜冰鞋
ski	滑雪；滑雪板
skip	蹦跳；略過
skyscraper	摩天大樓
slave	奴隸
slavery	奴役；奴隸身分
sleeve	衣袖
slice	把...切成薄片；薄片
slippery	光滑的；狡猾的
slope	斜面；傾斜
smooth	平滑的；順暢的；順利的
snap	斷裂
solid	固體的；堅實的；固體
someday	有朝一日
somehow	以某種方式；不知怎樣地
sometime	某個時候
somewhat	有點，稍微；多少
sore	痛的
sorrow	悲傷
sorrowful	傷心的
spade	鏟子；(撲克牌的)黑桃
specific	明確的；特別的
spice	香料；情趣
spill	使溢出
spin	使旋轉；用...紡
spit	吐口水；狠狠說出；口水
spite	惡意
splash	潑濺
spoil	毀掉；溺愛
spoils	掠奪物
sprain	扭傷
spray	噴；水花；噴霧器
sprinkle	灑；下小雨
sprinkling	點滴，稀疏
sprinkler	灑水器
spy	監視；間諜
squeeze	擠出
stab	刺；刺傷
stable	穩定的；馬廄
stadium	露天大型體育場
staff	職員
stale	不新鮮的；走味的
stare	凝視，瞪
starve	挨餓；餓死
starvation	挨餓；餓死
statue	雕像
steady	使穩定；穩定的
steep	陡峭的；(價格)過高的
stepfather	繼父
stepmother	繼母
stereo	立體音響設備
sticky	黏的；棘手的
stiff	僵硬的；固執的
sting	螫；毒針
stir	攪拌；煽動
stitch	縫合
stocking(s)	長襪
stool	(無椅背的)凳子
stormy	暴風雨的；激烈的
strategy	策略
strength	力氣
strip	剝掉；脫去(衣物)；細長條
structure	結構；組織；建築
stubborn	固執的
studio	工作室；錄音室
stuff	塞；物品
stuffy	通風不良的；塞住的
style	方式；款式；品味
submarine	潛水艇
substance	物質
suburb	郊區
suburban	郊區的
suck	吸取
suffer	遭受；罹患
suffering	痛苦
sufficient	足夠的
suggest	建議；暗示
suicide	自殺
suitable	適合的
sum	總和；金額
summary	概述；摘要
summit	頂點
superior	上級的；較優勢的
suppose	猜想；假設
surround	圍繞
surrounding	周圍的
survey	調查；檢查
survival	生存
survivor	生存者
suspect	懷疑；認為；嫌疑犯
suspicion	疑心
swear	發誓；咒罵
sweat	流汗；汗水
swell	增加；腫脹
swift	迅速的
switch	改變；轉換；開關
sword	劍，刀
system	系統；體制
tablet	藥片；匾額
tack	用大頭針固定；大頭針
tag	貼標籤；標籤
tailor	裁縫；縫製
tame	馴養；溫馴的
tap	輕拍，輕敲；水龍頭
tax	徵稅；稅
tease	戲弄；揶揄
technical	技術性的
technique	技巧；技術
technology	科技
temper	脾氣，心情；憤怒
temperature	溫度
temporary	暫時的；權宜的
tend	傾向於...；有助於...
tender	嫩的；親切的
territory	領土；轄區；地盤
text	正文
thankful	感謝的
theory	理論；假設；學說
thirst	口渴；渴望
thread	穿線；線
threat	威脅
threaten	威脅
tickle	搔癢；癢的感覺
tide	潮流；潮汐的漲退；形勢
tidy	整潔的
tight	緊的；緊密地
tighten	拉緊
timber	木材
tissue	(細胞)組織；面紙
tobacco	菸草
ton	噸
tortoise	陸龜
toss	拋擲
tourism	觀光事業；旅遊業
tourist	觀光客
tow	拖拉；牽引
trace	追蹤；蹤跡
trail	拖曳；追蹤；蹤跡
transport	運送；流放；運輸
trash	垃圾
traveler	旅行者
tray	托盤
tremble	顫抖
trend	潮流；流行
tribe	種族；(原始)部落
tricky	狡詐的
troop	人群；軍隊
tropical	熱帶(地區)的
tropic	熱帶(地區)；回歸線
trunk	後車箱；樹幹；象鼻
truthful	誠實的
tub	盆子；桶子；浴缸
tug	猛拉；拖船
tulip	鬱金香
tumble	跌落，跌倒
tune	曲子；調到(某頻道)
tutor	當家教；家教
twig	細枝
twin	雙胞胎之一；一對中的一個
twist	扭曲；捲繞
typewriter	打字機
typical	典型的；特點的
union	結合；合併；聯盟
unite	合併
unity	整合性；結合
universe	宇宙；全世界
unless	除非
upset	弄翻；使煩惱
vacant	空的；空虛的；空缺的
valuable	寶貴的
van	箱型卡車
vanish	消失
variety	多變性；差異；種類
various	各種的
vary	改變；使多樣化
vase	花瓶
vehicle	交通工具；車輛
verse	韻文；詩歌的節
vessel	容器；船
vest	背心；內衣；汗衫
vice-president	副總統；副校長；副總裁
victim	犧牲者
vinegar	醋
violence	強烈；暴力
violent	猛烈的；暴力的
violet	紫羅蘭；藍紫色的
virus	病毒
visible	可見的；明顯的
vision	視力；視野；遠景
vitamin	維他命
vivid	鮮豔的；清楚的；生動的
volume	冊；容積；音量
wage(s)	工資
wagon	貨運馬車；攤販的小車
waken	喚醒
wander	漫遊；蜿蜒前進
warmth	暖和；古道熱腸
warn	警告
warning	警告，注意
wax	蠟
weaken	使虛弱
wealth	財富
wealthy	富裕的
weave	編織；編造；穿梭而行
web	網子；蹼
weed	雜草
weep	哭泣
welfare	福利；社會福利
wheat	小麥
whip	鞭打；馬鞭
whisper	耳語；傳聞
whistle	吹口哨；哨子；汽笛
wicked	惡劣的
willow	柳樹，柳木
wink	眨眼
wipe	擦拭
wisdom	智慧
wrap	包，裹；包裝的材料
wreck	破壞；遇難；殘骸
wrist	手腕
X-ray/x-ray	照X光片；X射線
yawn	打呵欠
yell	喊叫
yolk	蛋黃
youngster	年輕人
zone	地區