ability	能力
abroad	去(在)國外
absence	缺席
absent	缺席的
accept	接受
accident	意外事件
active	活躍的；積極的
addition	添加
advance	前進；進步
affair	事件
aid	援助
aim	目標；瞄準；志在
aircraft	航空器
airline	航空公司；航線
airliner	(大型)定期客機
alarm	警報；使恐懼
album	黏貼簿；專輯
alike	相同的；相同地
alive	活的；有生氣的
aloud	發出聲音地；大聲地
alphabet	字母
alphabetic(al)	依字母順序的
although	雖然
altogether	完全地；大體上
amount	量
ancient	古代的
ankle	腳踝
anyhow	無論如何
anytime	無論何時；不客氣
anywhere	任何地方
apartment	公寓
appearance	出現；外貌
appetite	胃口
appetizing	促進食慾的
appetizer	開胃菜
apply	應用；申請；適合
apron	圍裙
argue	討論；爭論
arguement	議論；理由
arm	武裝
armchair	扶手椅
arrange	整理；安排；商量
arrangement	整理；安排；商議
arrest	逮捕
arrive	到達
arrow	箭
article	物品；報導
artist	藝術家
asleep	睡著的
assistant	輔助的；助理
attack	攻擊；發病
attend	出席；注意
attentive	專注的
attentively	專注地
attention	注意力
avoid	避免
baby-sit	當臨時保母
baby-sitter	保母
backward(s)	向後地
badminton	羽毛球
bake	烘烤
bakery	麵包店
baker	麵包師傅
balcony	陽台
bamboo	竹
banker	銀行家
barbecue	火烤；串燒
bark	吠叫；樹皮
basement	地下室
basis	基礎
battle	戰鬥；作戰
bead	珠子；飾以珠子
bean	豆子
bear	運送；支持；忍受；生育
beard	山羊鬍
bedroom	臥室
beef	牛肉
beer	啤酒
beetle	甲蟲
beg	乞討；懇請
beginner	初學者
belief	相信；信仰
believable	可信的
belt	皮帶；腰帶
bench	長凳
bend	使彎曲；彎曲
besides	除此之外
bet	打賭
beyond	越過
bill	帳單；鈔票；法案
bind	綁；束縛
birth	誕生；出身
bitter	苦的
blackboard	黑板
blank	空白的；空白處
blind	盲目的
bloody	殘忍的；血腥的
board	板；膳食；委員會；寄宿；乘坐
boil	燒開；沸騰
bomb	炸彈
bony	骨瘦如柴的
bookcase	書櫥
borrow	借入
bother	費神；麻煩
bottle	瓶子
bow	弓；蝴蝶結；鞠躬
bowling	保齡球
brain	腦
branch	樹枝；分店；分岔
brand	品牌
brick	磚
brief	短暫的；簡潔的；摘要
broad	寬闊的
broadcast	廣播；廣播節目
brunch	早午餐
brush	刷子；刷
bundle	包；捆；束
burn	燒
burst	爆發
business	工作；商業；該做的事
businessman	商人
button	鈕扣
cabbage	甘藍菜
cable	電纜
café	咖啡館；餐館
cafeteria	自助餐廳
calendar	日曆
calm	平靜的
campus	校園
cancel	取消
cancer	癌
candle	蠟燭
captain	隊長；船長
carpet	地毯
carrot	胡蘿蔔
cart	手推車
cartoon	卡通
cash	現金
cassette	卡式磁帶
castle	城堡
cave	洞穴
ceiling	天花板
celebrate	慶祝
cell	細胞
central	中央的
century	世紀
cereal	穀物食品
chalk	粉筆
change	改變；找零錢
character	性格；人物
charge	收費；充電
cheap	便宜的；卑鄙的
cheat	欺騙；作弊
chemical	化學的
chess	西洋棋
childish	幼稚的
childlike	天真的
chin	下巴
chocolate	巧克力
choice	選擇權
choose	選擇；選舉
chopstick(s)	筷子
circle	圓圈；週期；圈子
citizen	公民
claim	主張；要求；奪走(人命)
clap	拍(手)
classic	典型的；經典之作
claw	爪子
clay	黏土；泥土
clerk	店員
clever	聰明的
climate	氣候
closet	櫥櫃
cloth	布
clothe	穿衣服
clothes	衣服
clothing	衣類
cloudy	多雲的
clown	小丑
club	俱樂部；棍子
coach	教練；大型四輪馬車
coal	煤炭
cock	公雞
cockroach	蟑螂
coin	硬幣
collect	收集；對方付費的
colorful	多采多姿的
comb	梳子
comfortable	舒適的
comfortably	舒適地
company	公司；同伴
compare	比較；比喻
complain	抱怨
complete	完成的
completely	完全地
computer	電腦
confident	確信
confirm	確認
conflict	衝突
congratulation(s)	道賀
consider	考慮；認為
considerate	體貼的
contact	接觸
contain	包含
control	控制
convenient	方便的
conversation	對話
cooker	炊具
copy	複本；仿效
corner	街角；角落
costly	貴的
cotton	棉花
cough	咳嗽
countryside	鄉下
county	縣；郡
couple	兩個；一對
courage	勇氣
court	球場；法院
cousin	表(堂)兄弟姊妹
crab	螃蟹
crane	鶴；起重機；伸長脖子
crayon	蠟筆
crazy	發狂的
cream	乳液
create	創造
crime	罪
crisis	危機
critical	病危的；決定性的
crop	農作物
cross	穿越；使交叉；十字架
crow	雞啼叫
crowd	人群；擠滿
cruel	殘忍的
culture	教養；文化
cure	治療
curious	好奇的
curiously	覺得新奇地
current	現在的；通行的
curtain	窗簾
custom	習慣
customer	顧客
daily	每日的；日報
damage	損害
dangerous	危險的
data	資料
dawn	黎明
deaf	聾的
debate	爭論
debt	債務；恩情
decision	決定；決心
decorate	裝飾；裝潢
degree	程度；學位
delay	延遲
delicious	美味的
deliver	投遞
dentist	牙醫
deny	否認
denial	否認
department	部門；科系
depend	依賴；信賴
depth	深度
describe	描述
desert	拋棄；沙漠
deserted	荒涼的；被拋棄的
design	設計
desire	慾望；期望
dessert	甜點
detect	查出
develop	發展；沖洗(底片)
development	發展
dial	撥電話；(電話)轉盤
diamond	鑽石
diary	日記
dictionary	字典
difference	差異
difficulty	困難
dinosaur	恐龍
direction	方向；導演
director	指揮；導演；董事
disagree	不一致
disagreement	意見不合；爭議
disagreeable	不愉快的；難相處的
disappear	消失
disappearance	消失
discuss	討論
discussion	議論
dishonest	不誠實的
dishonesty	不誠實
display	展示；表露
distance	距離；遠方
distant	遠(方)的
divide	分割；除法
division	分割；除法
dizzy	頭暈的
dolphin	海豚
donkey	驢；頑固的人；笨蛋
dot	點
double	加倍
doubt	懷疑
doughnut	甜甜圈
downtown	商業區
Dr.	醫生
drag	拉；拖；累贅
dragon	龍
dragonfly	蜻蜓
drama	戲劇
drawer	抽屜
drawing	圖畫
dress	穿衣；洋裝
drop	滴落
drug	藥品
drugstore	藥局
drum	鼓
dryer	烘乾機
dull	鈍的；遲鈍的
dumb	啞的；沉默的；笨的
dumpling	餃子
duty	義務；稅金
earn	獲得
earthquake	地震
eastern	東方的
education	教育
effect	結果；影響
effective	有效果的
effort	努力；力氣
elder	年長的
elect	選出
element	元素；成分
elevator	電梯
emotion	情緒
encourage	鼓勵
encouraging	令人鼓舞的
encouragement	鼓勵
ending	結局
enemy	敵人
energy	精力；能量
enjoy	享受
enjoyment	喜樂
entire	全體的；完整的
entirely	完全地
entrance	進入；入口
envelope	信封
environment	環境
eraser	橡皮擦
error	錯誤
especial	特別的
especially	特別地
event	事件；一項比賽
eventful	多事的
exact	正確的；精確的
exactly	正確地；精確地
excellent	優秀的
excel	擅長
excite	使...興奮
excited	感覺興奮的
exciting	使人興奮的
excitement	興奮
excuse	原諒；藉口
exercise	運動；練習
exist	存在；發生
expect	期望；預期
expensive	昂貴的
experience	經驗；體驗
experienced	有經驗的
expert	專家；熟練的
explain	說明
express	表達
extra	額外的
eyebrow(s)	眉毛
fail	失敗
failure	不足；失敗者
fair	公平的；博覽會
famous	著名的
fault	挑出毛病；缺點
favor	支持；偏愛
favorite	最喜愛的
fearful	害怕的
fee	費用
fellow	同伴的；傢伙
fellowship	同伴情誼
female	女性
fence	圍籬
festival	慶典；節日
fever	發燒；狂熱
field	原野；戰場
fighter	戰士；戰鬥機
figure	想；圖案
film	拍攝；弄模糊；軟片
firm	堅硬的；堅決的
fit	適合
fix	固定；專注；修理
flag	旗幟
flash	閃光
flashlight	手電筒
flat	平坦的
flight	飛翔；飛機航次
flood	淹水；洪水
flour	麵粉
flow	流動；漲潮
flu	流行性感冒
flute	橫笛
focus	焦點；集中
foggy	濃霧的；不清的
following	下列的
fool	愚弄；傻子
foolish	愚笨的
foreigner	外國人
forgive	原諒
forgiving	寬大的
form	形成；表格
formal	正式的；形式的
formality	拘謹；正規手續
former	以前的；前者
forward	轉遞；進步的；向前
fox	狐狸
frank	直率的
frankly	直率地
freedom	自由；免除
friendly	友善的
fright	驚嚇
frighten	使驚嚇
frightened	受驚的
frightening	駭人的
function	功能；運轉
further	更遠的；更深的；更早的
future	未來的
gain	獲得
garage	車庫；修車廠
garbage	垃圾
gardener	園丁
gate	大門；出入口
gather	收集
general	將軍
generous	慷慨的
generously	慷慨地
gentle	溫和的
gently	溫和地
gentleman	紳士
geography	地理；地形
giant	巨大的；巨人；大人物
giraffe	長頸鹿
glove(s)	手套
glue	膠水
goal	目標；得分
goat	山羊
golden	金色的；極好的
golf	高爾夫球
golfer	打高爾夫球的人
govern	支配；管理
government	政府
grade	等級；年級；分數
grader	...年級學生
grape	葡萄
grapevine	葡萄藤
greedy	貪心的
greed	貪心
greet	問候；迎接
growth	生長
guard	看守；守衛
guava	番石榴
guitar	吉他
guy	傢伙
habit	習慣
hall	大廳；走廊
hammer	槌子
handkerchief	手帕
handle	處理；把手
handsome	英俊的；大方的
hang	掛；絞死
hanger	衣架
hardly	幾乎不
healthy	健康的
heater	暖氣設備
height	高度
helpful	有助益的
hen	母雞
hero	英雄
heroine	女英雄
hide	隱藏
highway	主要幹道；公路
hip	臀部；腰
hippopotamus/hippo	河馬
hire	雇用；租借
hobby	嗜好
honest	誠實的
honey	蜂蜜
hop	輕輕跳躍
hospital	醫院
hospitalize	使住院
host	主人；主持人
hostess	女主人
hotel	旅館
however	無論如何
hum	嗡嗡作響；哼歌
humble	謙虛的；卑賤的；貧困的
humbly	謙虛地；低下地
humid	潮濕的
humor	幽默；氣質
hunger	飢餓；渴望
hunt	狩獵
hunter	獵人
hurry	匆忙
hurried	匆忙的
hurriedly	匆忙地
ignore	忽視
ill	生病的；不正當的
imagine	想像；假設；認為
importance	重要性
improve	改善
improvement	改善
include	包括
inclusive	包含的
income	收入
increase	增加
independence	獨立
independent	獨立的
indicate	指示；暗示
indicative	指示的；象徵的
industry	工業；勤勉
industrious	勤勞的
influence	影響
ink	墨水
insect	昆蟲
insist	堅持；強迫
insistence	堅持
insistent	堅持的
instance	情況；例子
instant	立即的
instantly	馬上地
instrument	儀器；樂器
international	國際性的
internationally	國際地
interview	會見；面談
introduce	介紹
invent	發明
invitation	邀請
invite	邀請；請求
inviting	誘人的
island	島
item	項目
jacket	外套
jam	塞滿
jazz	爵士樂
jeans	牛仔褲
jeep	吉普車
jog	慢跑
jogger	慢跑者
joint	共同的；關節
judge	判決；法官
judgment	判決；判斷力
juicy	多汁的
ketchup	番茄醬
kindergarten	幼稚園
kingdom	王國；領域
knock	敲擊
knowledge	知識；學問
lane	小路；車道
language	語言
lantern	燈籠
lap	坐著時膝部與大腿部分
latest	最新的；最近的
lawyer	律師
leadership	領導力；領導地位
legal	法律上的；合法的
legally	法律上地；合法地
lemon	檸檬
lemonade	檸檬汁
lend	借出
length	長度
lettuce	萵苣；生菜
library	圖書館
lick	舔一下
lid	蓋子
lightning	閃電
limit	限制
limited	有限制的
link	連接
liquid	液體
listener	聽眾
loaf	(一條)麵包
local	本地的
locate	設置
lock	鎖
log	木材
lonely	孤獨的；寂寞的
loneliness	寂寞
lose	失去；輸
lost	遺失的
loser	失敗者
loss	失去；損失
lovely	美麗的；可愛的；極好的
lover	情人
lower	下方的；降低
luck	運氣
magazine	雜誌
magic	魔法；魔術的
magician	魔術師
maintain	維持；堅稱
maintenance	維持；維修；保養
male	男性；雄性的
Mandarin	國語；普通話
mango	芒果
manner	方法；態度
mark	標記；打分數
marriage	結婚；婚姻生活
mask	面具；遮掩
mass	塊；大量
mat	墊子
match	相配；比得上
mate	配偶；朋友
material	材料；世俗的
meal	餐
meaning	意義
meaningless	無意義的
means	方法；財富
measure	測量；標準；手段
measurement	測量；尺寸
medicine	藥；醫學
meeting	會議
melody	曲調；旋律
melon	甜瓜；香瓜
member	會員；一份子
memory	記憶力；回憶
menu	菜單；選單
message	信息
metal	金屬
meter	公尺；計量器
method	方法
microwave	微波；微波爐
military	軍隊；軍事的
million	百萬
mine	礦坑；我的
minus	減法；負的
mirror	鏡子；反映
mix	混合
model	模型；模特兒
modern	現代的；時髦的
monster	妖怪；怪物
mosquito	蚊子
motion	運行；用手勢示意
motionless	不動的
motorcycle	摩托車
movable	可以移動的
MRT/mass rapid transit	捷運
metro	地鐵
multiply	乘；增加
museum	博物館
musician	音樂家
nail	釘子；釘住
naked	赤裸的
napkin	餐巾
narrow	窄小的；勉強的
narrowly	勉強地
national	國家的；全國的
naughty	頑皮的
naughtily	頑皮地
nearby	附近的
nearly	幾乎
neat	整齊的；很棒的
neatly	整齊地
necessary	必要的
necessarily	必定地
needle	針；針葉
negative	負面的；消極的；底片
neighbor	鄰居
neither	兩者皆不
nephew	姪子；外甥
nest	鳥巢
net	網子
niece	姪女；外甥女
nobody	沒有人；無名小卒
nod	點頭
none	沒有人；一點也不
noodle	麵條
northern	北方的
novel	小說
nut	堅果
nuts	瘋狂的；熱愛的
obey	聽從；服從
object	物體；目的；受詞；反對
occur	發生；想起
offer	提出；願意做
official	官方的；公務員
officially	正式地；表面上地
omit	省略；疏忽
onion	洋蔥
operate	操作；開刀
opinion	意見
ordinary	普通的；平凡的
ordinarily	通常
organ	器官
organization	組織
organize	組織；系統化
oven	烤爐；烤箱
overpass	高架橋；陸橋
overseas	海外的；在海外
owl	貓頭鷹
owner	物主；所有權人
ox	公牛
pack	一包；塞滿
package	包裹；包裝
pain	疼痛；辛勞
painful	疼痛的；痛苦的
painfully	痛苦地；費力地
painter	畫家
painting	畫
pajamas	睡衣褲
palm	手掌；棕櫚樹
pan	平底鍋
panda	貓熊
papaya	木瓜
paragraph	段落
pardon	原諒
parrot	鸚鵡
particular	特別的；挑剔的
particularly	尤其
partner	夥伴；合夥人
passenger	乘客
paste	糨糊；(用糨糊)貼上
pat	輕拍
path	小徑；通路
patient	病人；有耐心的
patiently	有耐心地
pattern	圖案；模式；典範
peace	和平；安寧
peaceful	和平的
peacefully	和平地
peach	桃子
peanut	花生
pear	梨
penguin	企鵝
pepper	胡椒粉；青椒；甜椒
per	每
perfect	完美的
perfectly	完美地；非常地
personal	個人的；私人的
personally	親自地；私下地
photograph	相片
photographer	攝影師
photographic	攝影的
phrase	片語；表明；闡述
pick	挑選；摘花
picnic	野餐
pigeon	鴿子
pile	堆；堆積
pillow	枕頭
pin	大頭針；釘住
pineapple	鳳梨
ping-pong	乒乓球
pink	粉紅色的
pipe	菸斗；管子；吹笛子
pitch	音調；投球
pitcher	投手
pizza	披薩
plain	平原；清楚的；樸素的
plainly	清楚地
planet	行星
plate	盤子
platform	月台；講台
pleasant	舒適的；令人愉快的
pleasantly	和藹可親地；令人愉快地
pleasure	樂事；快樂
plus	加上
poem	詩
poet	詩人
poison	毒藥；汙染
policy	政策；策略
polite	有禮貌的
politely	有禮貌地
politeness	禮貌
popular	受歡迎的；大眾化的
population	人口
populate	居住於
populous	人口稠密的
pork	豬肉
port	港；港口
pose	姿勢；提出(問題)
positive	明確的；肯定的
positively	斷然地；的確
possibility	可能性
post	郵件；郵政；柱子；職位；委任
postcard	明信片
pot	鍋；壺
potato	馬鈴薯
pound	磅；英鎊
powerful	強而有力的
powerfully	強而有力地
praise	讚美
pray	禱告
prefer	較喜歡
preference	偏好
presence	存在；出席
present	出席的；現在的；禮物；呈獻；提出
presently	不久；很快地；目前
president	總統；校長；主席；總裁
press	新聞界；期刊；按壓
pride	自尊心；驕傲
prince	王子
princess	公主
principal	主要的；校長
principle	原則；原理
printer	印表機
prison	監獄
prisoner	囚犯
private	私人的
privately	秘密地
prize	獎品；珍惜
produce	製造；農產品
producer	製作人
progress	進行；進步
progressive	進步的；漸進的
project	計畫；投射
projector	投影機
promise	承諾
pronounce	發音；宣布
propose	提議；求婚
protect	保護；防禦
proud	驕傲的；引以為榮的
proudly	得意地
provide	提供
pudding	布丁
pump	抽取；幫浦
pumpkin	南瓜
punish	處罰
punishment	處罰
punishable	應該處罰的
pupil	學生
puppy	小狗
purse	錢包
puzzle	謎題；使困惑
quality	品質；優秀
quantity	量
quarter	四分之一；十五分鐘；一季
quit	停止；放棄
quiz	小考；詢問
rabbit	兔子
rainy	下雨的；多雨的
range	範圍；分布；排列
rapid	快速的
rapidly	快速地
rare	罕見的；稀少的
rarely	很少
rather	稍微；相當
reality	現實；事實
realize	使...成真；瞭解
recent	最近的
recently	最近地
record	記錄；錄影
rectangle	長方形
refrigerator	冰箱
refuse	拒絕
regard	注意；尊敬
regardless	不注意的
region	地區
regular	規律的；例行的
regularly	規律地
reject	拒絕
relation	關係；親戚
relationship	關係
repeat	重複；重播
reply	回應
reporter	記者
require	需求
requirement	必要條件
respect	尊敬
respective	各自的
respectively	各自地
responsible	有責任的
restaurant	餐廳
result	結果；導致
review	調查；複習；評論
reviewer	評論家
riches	財富
rock	搖動；使震撼
role	角色
royal	皇室的
rude	未加工的；粗魯的
ruler	統治者；尺
runner	跑步者
rush	衝進；倉促地做
safety	安全
sailor	水手
salad	沙拉
sample	樣品；抽樣
sandwich	三明治
satisfy	滿意；滿足
satisfied	滿意的
sauce	醬料；增添趣味的事物
scarf	圍巾
science	科學
scientist	科學家
scissors	剪刀
score	得分；樂譜
screen	螢幕；屏風；紗窗；篩子
search	搜索；調查；研究
secret	秘密；私下的
secretary	秘書
section	部分；欄；切片
select	選擇
selection	選擇
selective	選擇的；精選的
semester	學期
separate	分開；區別
separated	分離的
serious	認真的；嚴重的；嚴肅的
seriously	認真地；嚴肅地
servant	僕人
settle	安放；穩定；殖民；解決(問題)
settlement	解決；殖民地；結算
share	共有；分配；貢獻
shelf	棚；架
shell	貝殼；殼
shock	衝擊；使觸電
shocked	震驚的
shoot	射擊；拍攝
shot	射擊；注射
shorts	短褲
shower	淋浴；驟雨
shrimp	小蝦
sign	簽名；示意；招牌；姿勢；信號；前兆
silence	寂靜；沉默
silent	寂靜的；沉默寡言的
silk	絲
similar	相似的
simply	簡單地；僅僅
single	單一的；獨身的
sink	沉；陷；水槽；洗臉台
skillful	熟練的
skinny	皮包骨的；很瘦的
skirt	裙子
sleepy	想睡的
slender	苗條的；修長的
slide	滑行
slim	苗條的；微小的
slip	滑跤；滑落
slipper(s)	(室內)拖鞋
snack	(兩餐之間的)點心
snail	蝸牛
snowy	下雪的；雪白的
soccer	英式足球
social	社交的；社會的
society	社會；協會
sock(s)	短襪
soldier	士兵
solution	解決；溶解
solve	解決
somebody	重要人物；有人
somewhere	在某處
sort	分類；種類
source	泉源；出處；原因
southern	南方的；南部的
soy	醬油
soybean	大豆
spaghetti	義大利麵
speaker	演講者
speed	加速；速度
spelling	拼字
spider	蜘蛛
spinach	菠菜
spirit	靈魂；情緒
spot	發現；認出；斑點；地點
spread	伸展；塗抹；擴散
spring	跳躍；彈回
square	正方形的；廣場
squirrel	松鼠
stage	上演；舞台；階段
stamp	踩；蓋章；郵票；貼郵票
standard	標準；模範
steak	牛排
steal	偷竊
steam	蒸氣
steel	鋼
stick	伸出；貼；忍受；刺入；棒子；樹枝
storm	暴風雨；咆嘯
stove	火爐
straight	直率的；純粹的；連續的
stranger	陌生人；外行人
straw	吸管；稻草
strawberry	草莓
stream	小河流；潮流；流動
stress	強調；壓力；重音
stressful	充滿緊張感的
stretch	伸展；伸出
strict	嚴厲的；精準的
strike	敲打；襲擊；突然變得；罷工；好球
string	串聯；緊張；繩子；弦；一系列
struggle	掙扎；搏鬥
subject	主題；科目；使臣服
subjective	主觀的
subtract	減去
subtraction	減去
subway	地鐵
succeed	成功
success	成功
successful	成功的
sudden	突然的
suddenly	突然地
suit	適合；一套衣服
sunny	晴朗的；開朗的
supermarket	超市
supply	提供；儲存
support	支持；養活；證明
surface	浮出表面；表面
survive	生存
swallow	吞嚥；燕子
swan	天鵝
sweater	毛衣
sweep	清掃；席捲
swing	搖擺；鞦韆
symbol	象徵；符號
talent	才能
talkative	多話的
tangerine	橘子
tank	槽；坦克
tape	錄音帶；膠帶
target	對象；目標
task	工作；任務
tasty	美味的
team	隊伍
tear	撕；眼淚
teen(s)	十幾歲
teenage	十幾歲的
teenager	十幾歲的少年
telephone	電話；打電話
television/TV	電視
temperature	溫度；體溫
temple	廟宇；太陽穴
tennis	網球
tent	帳篷
term	任期；學期；專門用語
terrible	可怕的；駭人的
terribly	非常地；恐怖地
terrific	很棒的
test	測驗
textbook	教科書
theater	電影院；劇場
therefore	因此
thick	厚的；濃的；充滿的
thicken	使變厚；使不清楚
thief	小偷
thin	薄的；瘦的；稀疏的
thirsty	口渴的；渴望的
throat	喉嚨
through	通過；經由；完全地
throughout	遍及；到處；完全
thumb	用拇指做手勢；拇指
thunder	打雷；雷
tip	翻倒；小費；尖端；秘訣
title	標題；頭銜
toast	烤；舉杯祝賀；吐司
toaster	烤麵包機
toe	腳趾頭
tofu	豆腐
toilet	廁所；馬桶
tomato	番茄
tongue	舌頭；語言
tooth	牙齒
topic	主題
tour	旅行；巡迴演出
towel	毛巾；抹布
tower	聳立；塔台
track	跟蹤；足跡；車轍
trade	交換；貿易
tradition	傳統；慣例
traditional	傳統的
traffic	交通；交易
trap	設陷阱；陷阱
travel	旅行
treasure	珍惜；寶藏
treat	對待；治療；請客
treatment	對待；治療
trial	審判；嘗試
triangle	三角形
trick	欺騙；把戲；惡作劇
trousers	長褲
truck	卡車
trumpet	小號；喇叭；吹噓
trust	相信；託付
truth	事實
tube	管子
tunnel	隧道
turkey	火雞
type	打字；類型；字體
typhoon	颱風
ugly	醜陋的；令人不愉快的
umbrella	(雨)傘
underwear	內衣褲
uniform	一樣的；制服
upon	在...之上
upper	上面的；地位較高的
used	用過的；習慣於
user	使用者
usual	通常的；普通的
usually	通常地
vacation	假期
valley	山谷
value	評價；重視
victory	勝利
video	錄影帶
village	村莊
violin	小提琴
visitor	訪客
vocabulary	字彙
volleyball	排球
vote	投票
voter	選民
waist	腰部
waiter	服務生
waitress	女服務生
wake	醒；使覺悟
wallet	皮夾
waterfall	瀑布
watermelon	西瓜
wave	揮手；波浪
weapon	武器
wed	與...結婚
weekday	平日
western	西方的
wet	濕的；浸濕
whale	鯨
whatever	無論什麼
wheel	車輪；方向盤
whenever	無論何時
wherever	無論哪裡
whoever	無論是誰
widen	使寂寞
width	寬度；知識的廣博
wild	野生的；猛烈的
willing	樂意的
windy	風大的
wing	翅膀；飛
winner	優勝者
wire	電線；電報
wise	明智的
within	在...之內
without	沒有
wolf	狼
wonder	驚奇；想知道
wonderful	不可思議的；極好的
wooden	木製的
wool	羊毛
woolen	羊毛的
worth	價值；值得...的
wound	傷害；受傷
yard	碼；院子
youth	年輕時代；年輕人；青春
zebra	斑馬