a/an	一個
able	有能力的
about	有關
above	在...之上
according	根據
across	穿過
act	行為
action	活動
actor/actress	演員
add	增加
address	住址
adult	成人(的)
afraid	害怕的
after	在...之後
afternoon	下午
again	再度
against	反對
age	年齡
ago	...之前
agree	同意
agreement	協定
ahead	向前
air	空氣
airmail	航空郵件
airplane	飛機
airport	機場
all	全部的
allow	允許
almost	幾乎
alone	獨自
along	沿著
already	已經
also	並且
always	總是
among	在...之間
and	和
anger	憤怒
angry	生氣的
angrily	憤怒地
animal	動物
another	另一個
answer	回答
ant	螞蟻
any	任何
anything	任何事物
ape	類人猿(無尾)
appear	出現
apple	蘋果
April	四月
area	地區
arm	手臂
army	陸軍；軍隊
around	環繞
art	藝術
as	同樣的
ask	要求
August	八月
aunt	姑媽
autumn	秋天
away	離開地
baby	嬰兒
back	背部
bad	有害的
bag	袋子
ball	球；舞會
balloon	汽球
banana	香蕉
band	樂團；繩子
bank	河岸；銀行
bar	酒吧
barber	理髮師
base	基礎
baseball	棒球
basic	基礎的
basically	基本上
basket	籃子
basketball	籃球
bat	球棒；蝙蝠
bath	沐浴
bathe	浸泡
bathroom	浴室
beach	沙灘
bear	熊
beat	拍子
beautiful	美麗的
beautifully	美好地
beauty	美貌
because	因為
become	成為
bed	床
bee	蜜蜂
before	在...之前
begin	開始
beginning	開始
behind	在後面
believe	相信
bell	鐘
belly	肚子
belong	屬於
below	在下面
beside	在...旁邊
best	最好的
better	更好的
between	在...之間
bicycle	腳踏車
big	大的
bird	鳥
birth	出生
bit	少量
bite	咬
black	黑的
block	街區
blood	血
blow	吹
blue	藍色
boat	船
body	身體
bone	骨頭
book	書；預約
born	天生的
boss	老闆
both	兩者
bottom	底部
bowl	碗
box	箱子；拳擊
boy	男孩
brave	勇敢的
bread	麵包
break	休息
breakfast	早餐
bridge	橋梁
bright	閃耀的
bring	帶來
brother	兄弟
brown	棕色的
bug	昆蟲
build	建造
building	建築物
bus	公車
busy	忙碌的
but	但是
butter	奶油
butterfly	蝴蝶
buy	買
by	旁邊
cage	鳥籠
cake	蛋糕
call	呼叫
camel	駱駝
camera	照相機
camp	紮營
can	能夠；罐頭
candy	糖果
cap	帽子
car	汽車
card	卡片
care	擔心
careful	小心的
carefully	小心地
carry	運送
case	事件；箱子
cat	貓
catch	捕捉
cause	原因
cent	分（一美元的百分之一）
center	中央
certain	確實的
certainly	必定
chair	椅子
chance	機會
chart	圖表
chase	追蹤
check	檢查
chick	小雞
chicken	膽小鬼
chief	首領
child	小孩
Christmas	耶誕節
church	教堂
city	城市
class	班級
clean	乾淨的
clear	清楚的
climb	攀爬
clock	時鐘
close	關閉；親密的
closely	仔細地
cloud	雲
coast	海岸
coat	大衣
cocoa	可可亞
coffee	咖啡
coke	可口可樂
cold	冷的
color	顏色
come	來到
common	共同的
continue	繼續
continuous	無間斷的
cook	烹調
cookie	餅乾
cool	涼爽的
corn	玉米
correct	正確的
correction	改正
cost	花費
count	計數
country	國家；鄉下
course	路線；課程
cover	覆蓋
cow	母牛
cowboy	牛仔
crow	烏鴉
cry	哭喊
cub	新手；幼獸
cup	茶杯；獎盃
cut	切割
cute	可愛的
daddy	爸爸
dance	跳舞
dancer	舞者
danger	危險
dark	黑暗
date	日期；約會
daughter	女兒
day	白天
dead	死的
deal	交易
dear	親愛的
death	死亡
December	十二月
decide	決定
deep	深的
deeply	深深地
deer	鹿
desk	書桌
die	死
different	不同的
difficult	困難的
dig	挖掘
dinner	晚餐
direct	直接的；指導
dirty	骯髒的
discover	發現
dish	盤子
do	做
doctor/doc	醫生；博士
dog	狗
doll	打扮；洋娃娃
dollar	元
door	門
dove	鴿子
down	向下
downstairs	樓下
dozen	一打，十二個
draw	拉；畫
dream	夢想
drink	喝
drive	開車
driver	駕駛
dry	乾的
duck	鴨子
duckling	小鴨
during	在...期間
each	各自
eagle	鷹
ear	耳朵
early	早的
earth	地球；土壤
ease	放鬆
east	東方
easy	容易的
eat	吃
edge	邊緣
egg	蛋
eight	八
eighteen	十八
eighty	八十
either	兩者中任一；也
elephant	大象
eleven	十一
else	其他
end	結束
English	英文
enough	足夠的
enter	進入
equal	相等
even	均一的；甚至
evening	傍晚
ever	曾經
every	每個
examination	檢查
exam	考試
examine	檢查
example	例子
except	除...之外
eye	眼睛
face	面對；臉
fact	事實
factory	工廠
fall	落下；瀑布；秋天
false	錯誤的
family	家人
fan	電扇；粉絲
far	遠方的
farm	農場
farmer	農民
fast	快的
fat	肥胖的
father	父親
Father	神
fear	害怕
February	二月
feed	餵
feel	觸摸
feeling	感覺
few	少數
fifteen	十五
fifty	五十
fight	戰鬥
fill	裝滿
final	最後的
finally	最後
find	發現
finding	研究結果
fine	罰金；精巧的
finger	指頭
finish	完成
finished	完成了
fire	火；發射；熱情；開除
first	第一的
fish	魚
five	五
floor	地板
flower	花
fly	飛；蒼蠅
fog	霧
follow	跟隨
food	食物
foot	腳；英尺
for	為了
force	強迫；軍隊
foreign	外國的
forest	森林
forget	忘記
forgetful	健忘的
fork	叉子
forty	四十
four	四
fourteen	十四
free	免費的；自由的
fresh	新鮮的
Friday	星期五
friend	朋友
frog	青蛙
from	從...；防止
front	前面的
fruit	水果
full	滿的
fun	趣味
funny	好笑的
game	遊戲
garden	花園
gas	氣體；瓦斯
general	一般性的
generally	大致上
get	得到
ghost	鬼
ghostly	朦朧不清的
gift	禮物；天賦
girl	女孩
give	給予
glad	高興的
glass	玻璃
glasses	眼鏡
go	去
god	神
goddess	女神
gold	黃金
good	好的
goose	鵝
grand	宏偉的
grandchild	孫子
grandfather	祖父
grandmother	祖母
grandson	孫子
grass	草
gray/grey	灰色的
great	偉大的
green	綠色的
ground	土地
group	分類
grow	生長
guess	猜測
guest	客人
guide	引導
gun	槍
hair	頭髮
haircut	理髮
half	一半的
ham	火腿
hand	手；遞交
happen	發生
happy	高興的
hard	硬的
hat	帽子
hate	憎恨
have	擁有
head	頭；前進
health	健康
hear	聽
hearing	聽力
heart	心臟
hearty	真誠的
heat	加熱
heavy	沉重的
hello	哈囉
help	幫忙
here	在這裡
high	高的
highly	高高地
hill	小山丘
hilly	多丘陵的
history	歷史
hit	打擊
hold	抓；保持
hole	洞穴；瑕疵
holiday	假日
home	在家的
homework	習題
hope	希望
horse	馬
hot	熱的；流行的
hour	小時
house	房子
housing	住宅
how	如何
huge	巨大的
human	人
humane	有人性的
hundred	一百
hungry	飢餓的；渴望的
hurt	受傷
hurtful	有害的
husband	丈夫
ice	冰
idea	概念
if	假如...的話
important	重要的
in	在...之中
inch	緩緩向前；英吋
inside	在...內部
interest	興趣
interested	感興趣的
interesting	有趣味的
into	進入；陷入
iron	鐵；熨斗
jam	擁擠；果醬
January	一月
job	工作
join	結合
joke	笑話
joy	樂趣
juice	果汁
July	七月
jump	跳躍
June	六月
just	公平的；恰好
keep	保留
key	鑰匙；秘訣
kick	踢
kid	小孩；嘲笑
kill	殺死
killing	致命的
killer	殺手
kind	種類；仁慈的
kindness	仁慈
king	國王
kiss	吻
kitchen	廚房
kite	風箏
kitten	小貓
knee	膝蓋
knife	刀
know	知道
known	著名的
lack	缺乏
lady	女士
lake	湖泊
lamb	小羊
lamp	燈
land	陸地；登陸
large	大的
largely	大部分地
last	最後的；持續
lasting	永久的
late	遲的
later	稍晚
laugh	笑
law	法律
lay	生蛋；放置
lazy	懶惰的
lazily	懶洋洋地
laziness	懶惰
lead	引導
leading	領先的
leader	領袖
leaf	葉子；書頁
learn	學習
least	最少的
leave	離開
left	左邊
leg	腿
less	較少的
lesson	課；教訓
let	讓...
letter	信；字母
level	水平面
lie	謊言；躺
life	生命
lift	舉起
light	燈；輕鬆的
lightly	輕鬆地
like	像；喜歡
likely	可能
lily	百合花
line	線；排隊
lion	獅子
lip	嘴唇
list	名單
listen	聽
little	少的
live	居住；通電的
living	生活
long	長的；渴望
longing	渴望
look	看
lot	許多；籤
loud	大聲的
loudly	大聲地
love	愛
low	低的
lucky	幸運的
luckily	幸運地
lunch	午餐
machine	機器
mad	瘋狂的
madly	瘋狂地
madness	瘋狂
mail	郵件
main	主要的
mainly	主要地
make	製作；成為
man	男人
many	很多
map	地圖
March	三月
market	市場
marry	結婚
married	已婚的
master	碩士；主人；精通
match	比賽；火柴
matter	事務
May	五月
may	可能
maybe	也許
me	我
mean	卑鄙的；意思是
meat	肉類
meet	見面；滿足
middle	中間
mile	英里
milk	牛奶
mind	介意
minute	分鐘
Miss	小姐
miss	想念
mistake	錯誤
mistaken	錯誤的
Mister/Mr.	先生
moment	片刻
mommy	媽媽
Monday	星期一
money	金錢
monkey	猴子
month	月份
moon	月亮
more	更多的
morning	早上
most	最多的
mother	母親
mountain	山
mouse	老鼠；滑鼠
mouth	嘴巴
mouthful	一口的量
move	移動
movement	動作
movie	電影
Mrs.	太太
Ms.	女士
much	很多
mud	泥濘
mug	馬克杯
music	音樂；中聽的話
must	必須
my	我的
myself	我自己
name	名字
nation	國家
nature	自然
natural	不做作的
naturally	輕鬆地
near	接近
neck	脖子
need	需要
needless	不必要的
never	從未
new	新的
news	新聞
newspaper	報紙
next	接下來
nice	親切的
nicely	舒適的
night	夜晚
nine	九
ninth	第九的
nineteen	十九
ninety	九十
no	沒有；不
nope	不
noise	噪音
noisy	吵雜的
noisily	吵雜地
noon	中午
nor	也不
north	北方
nose	鼻子
not	不是
note	注意；筆記
noted	著名的
nothing	無
notice	注意到
November	十一月
now	現在
number	數字
nurse	護士；看護
okay	可以
ocean	海洋
o'clock	...點鐘
October	十月
of	...的
off	從...離開
office	辦公室
officer	公務員；軍官
often	經常
oil	油
old	老舊的
on	在...上面
once	一次；一旦
one	一個的
only	只
open	開放的
openly	公開地；坦白地
or	或者
orange	橘子；橘色
order	命令；點菜；秩序
orderly	有規律的
other	其他的
our(s)	我們的
out	從...向外；遠離的
outside	在...外面；戶外的
over	在...之上；結束
own	擁有；自己的
page	頁
paint	油漆；畫圖
pair	一對
pants	褲子
paper	紙；報告
parent(s)	父母
park	公園；停車
part	部分；分開
party	宴會；黨派
pass	通過；通行證
past	過去的；經過
pay	付款；薪水
payment	支付
pen	筆
pencil	鉛筆
people	人
perhaps	也許
period	一段時間
person	人
pet	寵物；寵愛的
piano	鋼琴
picture	照片；想像
pie	派
piece	一塊
pig	豬
piggy	像豬的
place	地方；放置
plan	計畫
plant	植物；工廠；種植
play	演奏；玩
playful	愛玩的
player	球員；唱機
playground	遊樂場
please	取悅；請
pocket	口袋
poetry	詩集
point	點；指出
police	警察
policeman	警察
policewoman	女警
pond	池塘
pool	小水塘；撞球
poor	貧窮的
poorly	貧窮地
popcorn	玉米花
position	位置
possible	可能
possibly	或許
impossible	不可能的
power	力量；電力
practice	練習；實行
prepare	準備
prepared	準備好的
pretty	漂亮的
prettily	漂亮地
price	價格
print	印刷
problem	問題
prove	證明
public	公共的
pull	拉；吸引
purple	紫色
purpose	目的
purposeful	意志堅決的
push	推；逼迫
put	放置
queen	女王
question	問題
quick	快速的
quickly	快速地
quiet	安靜
quietly	安靜地
quite	相當地
race	賽跑；種族
radio	收音機；無線電
railroad	鐵路
rain	雨
rainbow	彩虹
raise	提升；飼養
rat	老鼠
reach	伸手可及
read	閱讀
reader	讀者；讀本
ready	準備好的
readily	樂意地
real	真的
really	真正地
reason	根據
receive	收到
red	紅色
remember	記得；想起
rememberance	記憶
report	報告
rest	休息；剩餘
restless	浮躁不安的
return	回報
rice	米
rich	有錢的；豐富的
ride	騎乘
right	正確的；右邊；權利
ring	戒指；打電話
rise	上升
river	河流
road	道路
robot	機器人
rock	石頭
rocky	多岩石的
roll	滾動
roof	屋頂
room	房間
rooster	公雞
root	根
rooted	根深柢固的
rope	繩子
rose	玫瑰
rosy	玫瑰色
round	圓的；巡迴
row	一排；划船
rub	摩擦
rubber	橡膠
rule	統治；規則
run	跑步；運轉
sad	悲傷的
safe	安全的；保險櫃
sail	航行；帆船
sale	出售
salt	鹽
same	相同的
sand	沙
Saturday	星期六
save	拯救；節省；儲存
saw	鋸斷；鋸子
say	說
saying	諺語
scare	驚嚇
scared	害怕的
scene	景色
scenic	風景的
school	學校
schooling	學校教育
sea	海
season	季節
seat	座位；坐
second	秒；第二的
see	看見；理解
seed	種子；播種
seem	似乎
seesaw	蹺蹺板
self	自我
selfish	自私的
sell	販賣；背叛
send	送
sense	感覺
sentence	句子；判決
September	九月
serve	服務
service	服務；設施
set	放置；下沉；集合
seven	七
seventeen	十七
seventy	七十
several	數個
shake	搖動
shall	將會
should	應該
shape	外形；形狀
shark	鯊魚
sharp	銳利的；激烈的
she	她
sheep	羊
sheet	被單；一張
shine	發光
ship	船
shipping	貨運業
shirt	襯衫
shoe(s)	鞋子
shop	購物；商店
shopping	購物
shore	岸
short	短的
shot	射擊；注射
shoulder	肩膀；承擔
shout	大聲叫喊
show	展現
shut	關閉；打烊
shy	害羞的
sick	生病的；渴望的
side	面；觀點
sidewalk	人行道
sight	視力；名勝
silly	傻的
silver	銀色的
simple	簡單的
since	因為；自從
sing	唱歌
singer	歌手
sir	先生
sister	姊妹
sit	坐
six	六
sixteen	十六
sixty	六十
size	尺寸
skill	技術
skin	皮膚
sky	天空
sleep	睡眠
slow	緩慢的
small	小的；微少的
smart	聰明的；漂亮的
smell	聞
smile	微笑
smoke	抽菸；煙
snake	蛇；蜿蜒而流；狡詐的人
snow	下雪
snowflake	雪花
so	所以
soap	肥皂
soda	汽水
sofa	沙發
soft	柔軟的
soil	弄髒；土壤
some	一些
someone	某人
something	某事
sometimes	有時候
son	兒子
song	歌曲
soon	不久
sorry	遺憾
soul	靈魂
sound	聽起來；健康的；聲音
soup	湯
sour	酸的
south	南方
space	太空；空間
speak	演講
special	專門的
speech	演講
spell	拼寫；魔法
spend	花費
spoon	湯匙
sport	運動
spring	跳；彈簧；春天；溫泉
stair	樓梯
stand	站起來；座落
star	主演；明星；星星
start	開始
state	敘述；州
statement	聲明
station	車站；局
stay	停留；保持
step	步伐；手段
still	靜止不動的；仍然
stomach	胃
stone	石頭
stop	停止
store	儲藏；商店
story	故事；樓層
strange	不熟悉的
street	街道
strong	堅定的
student	學生
study	學習；研究
stupid	笨的
such	那樣的；如此
sugar	糖
summer	夏天
sun	太陽；恆星
Sunday	星期日
super	極好的
supper	晚餐
sure	確定的
surprise	驚訝
surprised	感到驚訝的
surprising	令人吃驚的
sweet	甜的
swim	游泳
table	桌子
tail	尾巴
take	拿
tale	故事
talk	談論
tall	高的
taste	嘗起來
taxi	計程車
tea	茶
teach	教導
teacher	教師
tell	說；分辨
ten	十
than	比...
thank	謝謝
that	那；那麼
the	這
their(s)	他們的
them	他們
then	然後
there	那裡
these	這些
they	他們
thing	東西
think	思考
third	第三
thirteen	十三
thirty	三十
this	這；如此
those	那些
though	不過；雖然
thought	打算；想法
thousand	千
three	三
throw	丟
Thursday	星期四
thus	因此
ticket	票；罰單
tie	領帶；綁；平手
tiger	老虎
time	時間；倍數
tiny	極小的
tire	使疲倦；輪胎
tired	厭煩的
today	今天；現今
together	一起
tomorrow	明天
tone	音調
tonight	今晚
too	也；太...
tool	工具
top	最高的；頂端
total	總計；完全的
touch	觸摸；感動
toward(s)	朝向...
town	城鎮
toy	玩弄；玩具
train	訓練；火車
trainer	教練
tree	樹
trip	旅行；絆倒
trouble	麻煩
true	正確的
try	嘗試
T-shirt	T恤
Tuesday	星期二
turn	轉彎；順序
twelve	十二
twenty	二十
twice	兩次
two	二
uncle	伯父
under	在下面
understand	明白
understanding	理解
unit	單位
until	直到...
up	向上
upstairs	在樓上
us	我們
use	使用
useful	有益的
useless	無用的
vegetable	蔬菜；植物人
vegetarian	素食者
very	非常地
view	眺望；見解
visit	參觀
voice	聲音
wait	等候
walk	走
wall	牆壁
want	想要；通緝
war	戰爭
warm	熱情的；暖和的
wash	洗滌
waste	浪費；廢物
watch	觀察；手錶
water	水
way	路線；作風
we	我們
weak	虛弱的
weakness	脆弱
wear	穿戴著；磨損
weather	天氣
wedding	結婚儀式
Wednesday	星期三
week	週
weekend	週末
weigh	秤重；仔細考慮
weight	重量；重要性
welcome	歡迎
well	健康的；很好地；井
west	西方
what	什麼
when	何時
where	哪裡
whether	是否
which	哪個
while	雖然；時間；度過
white	白色
who	誰
whole	全體的
whom	誰
whose	誰的
why	為什麼
wide	寬的
wife	妻子
will	將要；遺囑
win	獲勝
wind	彎曲；風
window	窗戶；視窗
wine	葡萄酒
winter	冬天
wish	希望
with	一起
woman	女人
wood(s)	木頭；森林
word	字詞
work	工作；發生效用；作品
worker	工人
world	世界
worldly	世故的
worm	蟲
worry	擔心
worse	較壞的
worst	最壞的
write	寫
writer	作者
wrong	不對的
yam	番薯
year	年
yellow	黃色
yes	是的
yesterday	昨天
yet	已經
you	你；你們
young	年輕的
your(s)	你們的
yuck	呸
yucky	討厭的
yummy	好吃的
zero	零
zoo	動物園