dance	跳舞
dangerous	危險的
dark	黑暗的
date	日期
daughter	女兒
day	日子
dead	死的
dear	親愛的
December	十二月
decide	決定
delicious	美味的
department store	百貨公司
desk	書桌
dictionary	字典
die	死亡
different	不同的
difficult	困難的
dig	挖掘
dining room	飯廳
dinner	晚餐
dirty	骯髒的
dish	盤子
do	做
doctor	醫生
dog	狗
doll	洋娃娃
dollar	元
door	門
down	向下地
dozen	一打
draw	拉
dream	夢
dress	打扮
drink	喝
drive	開車
driver	司機
drop	滴下
dry	乾的
during	在...期間